"Datum";"Region";"PCR_Pos";"Ag_Neg";"Ag_Pos";"Total";"Pocet.potvrdenych";"Potvrdenych";"newcases";"date";"positive"
2021-12-02;"Banskobystrický kraj";1710;0;0;0;76152;136515;1710;2021-12-02;136515
2021-12-01;"Banskobystrický kraj";947;3451;203;3654;NA;136515;1150;2021-12-01;134805
2021-11-30;"Banskobystrický kraj";1266;6391;238;6629;NA;136515;1504;2021-11-30;133655
2021-11-29;"Banskobystrický kraj";591;10616;461;11077;NA;136515;1052;2021-11-29;132151
2021-11-28;"Banskobystrický kraj";418;4277;212;4489;NA;136515;630;2021-11-28;131099
2021-11-27;"Banskobystrický kraj";827;1777;206;1983;NA;136515;1033;2021-11-27;130469
2021-11-26;"Banskobystrický kraj";963;4741;347;5088;NA;136515;1310;2021-11-26;129436
2021-11-25;"Banskobystrický kraj";1110;5877;344;6221;NA;136515;1454;2021-11-25;128126
2021-11-24;"Banskobystrický kraj";1387;5934;321;6255;NA;136515;1708;2021-11-24;126672
2021-11-23;"Banskobystrický kraj";1436;6070;377;6447;NA;136515;1813;2021-11-23;124964
2021-11-22;"Banskobystrický kraj";489;8713;568;9281;NA;136515;1057;2021-11-22;123151
2021-11-21;"Banskobystrický kraj";408;4104;298;4402;NA;136515;706;2021-11-21;122094
2021-11-20;"Banskobystrický kraj";985;1751;199;1950;NA;136515;1184;2021-11-20;121388
2021-11-19;"Banskobystrický kraj";1006;4872;461;5333;NA;136515;1467;2021-11-19;120204
2021-11-18;"Banskobystrický kraj";979;8023;608;8631;NA;136515;1587;2021-11-18;118737
2021-11-17;"Banskobystrický kraj";772;1049;141;1190;NA;136515;913;2021-11-17;117150
2021-11-16;"Banskobystrický kraj";1130;5461;444;5905;NA;136515;1574;2021-11-16;116237
2021-11-15;"Banskobystrický kraj";749;7857;576;8433;NA;136515;1325;2021-11-15;114663
2021-11-14;"Banskobystrický kraj";311;2629;302;2931;NA;136515;613;2021-11-14;113338
2021-11-13;"Banskobystrický kraj";761;1471;214;1685;NA;136515;975;2021-11-13;112725
2021-11-12;"Banskobystrický kraj";972;5018;434;5452;NA;136515;1406;2021-11-12;111750
2021-11-11;"Banskobystrický kraj";1023;5571;345;5916;NA;136515;1368;2021-11-11;110344
2021-11-10;"Banskobystrický kraj";950;4699;333;5032;NA;136515;1283;2021-11-10;108976
2021-11-09;"Banskobystrický kraj";921;4603;283;4886;NA;136515;1204;2021-11-09;107693
2021-11-08;"Banskobystrický kraj";519;7234;488;7722;NA;136515;1007;2021-11-08;106489
2021-11-07;"Banskobystrický kraj";460;2479;258;2737;NA;136515;718;2021-11-07;105482
2021-11-06;"Banskobystrický kraj";505;1344;170;1514;NA;136515;675;2021-11-06;104764
2021-11-05;"Banskobystrický kraj";997;4773;342;5115;NA;136515;1339;2021-11-05;104089
2021-11-04;"Banskobystrický kraj";1086;4811;248;5059;NA;136515;1334;2021-11-04;102750
2021-11-03;"Banskobystrický kraj";976;4825;330;5155;NA;136515;1306;2021-11-03;101416
2021-11-02;"Banskobystrický kraj";538;5709;492;6201;NA;136515;1030;2021-11-02;100110
2021-11-01;"Banskobystrický kraj";390;1178;132;1310;NA;136515;522;2021-11-01;99080
2021-10-31;"Banskobystrický kraj";150;1700;210;1910;NA;136515;360;2021-10-31;98558
2021-10-30;"Banskobystrický kraj";449;1508;140;1648;NA;136515;589;2021-10-30;98198
2021-10-29;"Banskobystrický kraj";780;4166;286;4452;NA;136515;1066;2021-10-29;97609
2021-10-28;"Banskobystrický kraj";744;4169;247;4416;NA;136515;991;2021-10-28;96543
2021-10-27;"Banskobystrický kraj";664;4577;233;4810;NA;136515;897;2021-10-27;95552
2021-10-26;"Banskobystrický kraj";700;3673;187;3860;NA;136515;887;2021-10-26;94655
2021-10-25;"Banskobystrický kraj";376;5478;257;5735;NA;136515;633;2021-10-25;93768
2021-10-24;"Banskobystrický kraj";161;1707;143;1850;NA;136515;304;2021-10-24;93135
2021-10-23;"Banskobystrický kraj";238;1286;79;1365;NA;136515;317;2021-10-23;92831
2021-10-22;"Banskobystrický kraj";530;3816;185;4001;NA;136515;715;2021-10-22;92514
2021-10-21;"Banskobystrický kraj";416;4128;140;4268;NA;136515;556;2021-10-21;91799
2021-10-20;"Banskobystrický kraj";387;3615;123;3738;NA;136515;510;2021-10-20;91243
2021-10-19;"Banskobystrický kraj";419;4094;103;4197;NA;136515;522;2021-10-19;90733
2021-10-18;"Banskobystrický kraj";162;5286;175;5461;NA;136515;337;2021-10-18;90211
2021-10-17;"Banskobystrický kraj";26;1555;71;1626;NA;136515;97;2021-10-17;89874
2021-10-16;"Banskobystrický kraj";162;1387;50;1437;NA;136515;212;2021-10-16;89777
2021-10-15;"Banskobystrický kraj";187;3693;81;3774;NA;136515;268;2021-10-15;89565
2021-10-14;"Banskobystrický kraj";198;3705;47;3752;NA;136515;245;2021-10-14;89297
2021-10-13;"Banskobystrický kraj";217;3068;55;3123;NA;136515;272;2021-10-13;89052
2021-10-12;"Banskobystrický kraj";301;3743;59;3802;NA;136515;360;2021-10-12;88780
2021-10-11;"Banskobystrický kraj";128;4734;96;4830;NA;136515;224;2021-10-11;88420
2021-10-10;"Banskobystrický kraj";26;1815;53;1868;NA;136515;79;2021-10-10;88196
2021-10-09;"Banskobystrický kraj";73;1122;27;1149;NA;136515;100;2021-10-09;88117
2021-10-08;"Banskobystrický kraj";239;3027;61;3088;NA;136515;300;2021-10-08;88017
2021-10-07;"Banskobystrický kraj";179;3437;42;3479;NA;136515;221;2021-10-07;87717
2021-10-06;"Banskobystrický kraj";136;3862;48;3910;NA;136515;184;2021-10-06;87496
2021-10-05;"Banskobystrický kraj";209;2979;54;3033;NA;136515;263;2021-10-05;87312
2021-10-04;"Banskobystrický kraj";126;3725;64;3789;NA;136515;190;2021-10-04;87049
2021-10-03;"Banskobystrický kraj";11;1407;34;1441;NA;136515;45;2021-10-03;86859
2021-10-02;"Banskobystrický kraj";66;1042;26;1068;NA;136515;92;2021-10-02;86814
2021-10-01;"Banskobystrický kraj";158;3228;51;3279;NA;136515;209;2021-10-01;86722
2021-09-30;"Banskobystrický kraj";120;3362;30;3392;NA;136515;150;2021-09-30;86513
2021-09-29;"Banskobystrický kraj";118;2626;40;2666;NA;136515;158;2021-09-29;86363
2021-09-28;"Banskobystrický kraj";112;3061;45;3106;NA;136515;157;2021-09-28;86205
2021-09-27;"Banskobystrický kraj";90;4456;72;4528;NA;136515;162;2021-09-27;86048
2021-09-26;"Banskobystrický kraj";17;1498;31;1529;NA;136515;48;2021-09-26;85886
2021-09-25;"Banskobystrický kraj";17;1481;7;1488;NA;136515;24;2021-09-25;85838
2021-09-24;"Banskobystrický kraj";98;4254;32;4286;NA;136515;130;2021-09-24;85814
2021-09-23;"Banskobystrický kraj";63;3019;13;3032;NA;136515;76;2021-09-23;85684
2021-09-22;"Banskobystrický kraj";75;2442;19;2461;NA;136515;94;2021-09-22;85608
2021-09-21;"Banskobystrický kraj";125;2976;20;2996;NA;136515;145;2021-09-21;85514
2021-09-20;"Banskobystrický kraj";45;3951;30;3981;NA;136515;75;2021-09-20;85369
2021-09-19;"Banskobystrický kraj";6;1456;24;1480;NA;136515;30;2021-09-19;85294
2021-09-18;"Banskobystrický kraj";44;1318;15;1333;NA;136515;59;2021-09-18;85264
2021-09-17;"Banskobystrický kraj";73;3485;32;3517;NA;136515;105;2021-09-17;85205
2021-09-16;"Banskobystrický kraj";95;3019;29;3048;NA;136515;124;2021-09-16;85100
2021-09-15;"Banskobystrický kraj";22;394;1;395;NA;136515;23;2021-09-15;84976
2021-09-14;"Banskobystrický kraj";95;2508;28;2536;NA;136515;123;2021-09-14;84953
2021-09-13;"Banskobystrický kraj";29;3206;28;3234;NA;136515;57;2021-09-13;84830
2021-09-12;"Banskobystrický kraj";7;958;15;973;NA;136515;22;2021-09-12;84773
2021-09-11;"Banskobystrický kraj";31;865;11;876;NA;136515;42;2021-09-11;84751
2021-09-10;"Banskobystrický kraj";59;2250;24;2274;NA;136515;83;2021-09-10;84709
2021-09-09;"Banskobystrický kraj";46;2011;17;2028;NA;136515;63;2021-09-09;84626
2021-09-08;"Banskobystrický kraj";46;1713;27;1740;NA;136515;73;2021-09-08;84563
2021-09-07;"Banskobystrický kraj";27;1422;21;1443;NA;136515;48;2021-09-07;84490
2021-09-06;"Banskobystrický kraj";26;2570;13;2583;NA;136515;39;2021-09-06;84442
2021-09-05;"Banskobystrický kraj";9;742;2;744;NA;136515;11;2021-09-05;84403
2021-09-04;"Banskobystrický kraj";14;745;10;755;NA;136515;24;2021-09-04;84392
2021-09-03;"Banskobystrický kraj";49;2116;22;2138;NA;136515;71;2021-09-03;84368
2021-09-02;"Banskobystrický kraj";19;1730;25;1755;NA;136515;44;2021-09-02;84297
2021-09-01;"Banskobystrický kraj";6;230;6;236;NA;136515;12;2021-09-01;84253
2021-08-31;"Banskobystrický kraj";18;1406;13;1419;NA;136515;31;2021-08-31;84241
2021-08-30;"Banskobystrický kraj";23;1867;10;1877;NA;136515;33;2021-08-30;84210
2021-08-29;"Banskobystrický kraj";0;351;5;356;NA;136515;5;2021-08-29;84177
2021-08-28;"Banskobystrický kraj";9;827;5;832;NA;136515;14;2021-08-28;84172
2021-08-27;"Banskobystrický kraj";7;1608;12;1620;NA;136515;19;2021-08-27;84158
2021-08-26;"Banskobystrický kraj";7;1161;2;1163;NA;136515;9;2021-08-26;84139
2021-08-25;"Banskobystrický kraj";6;1052;1;1053;NA;136515;7;2021-08-25;84130
2021-08-24;"Banskobystrický kraj";12;1117;1;1118;NA;136515;13;2021-08-24;84123
2021-08-23;"Banskobystrický kraj";7;1368;5;1373;NA;136515;12;2021-08-23;84110
2021-08-22;"Banskobystrický kraj";0;773;2;775;NA;136515;2;2021-08-22;84098
2021-08-21;"Banskobystrický kraj";3;793;1;794;NA;136515;4;2021-08-21;84096
2021-08-20;"Banskobystrický kraj";5;1616;4;1620;NA;136515;9;2021-08-20;84092
2021-08-19;"Banskobystrický kraj";4;1092;3;1095;NA;136515;7;2021-08-19;84083
2021-08-18;"Banskobystrický kraj";1;1044;1;1045;NA;136515;2;2021-08-18;84076
2021-08-17;"Banskobystrický kraj";12;890;0;890;NA;136515;12;2021-08-17;84074
2021-08-16;"Banskobystrický kraj";7;1321;3;1324;NA;136515;10;2021-08-16;84062
2021-08-15;"Banskobystrický kraj";0;366;3;369;NA;136515;3;2021-08-15;84052
2021-08-14;"Banskobystrický kraj";6;435;1;436;NA;136515;7;2021-08-14;84049
2021-08-13;"Banskobystrický kraj";11;898;0;898;NA;136515;11;2021-08-13;84042
2021-08-12;"Banskobystrický kraj";10;951;1;952;NA;136515;11;2021-08-12;84031
2021-08-11;"Banskobystrický kraj";7;575;3;578;NA;136515;10;2021-08-11;84020
2021-08-10;"Banskobystrický kraj";7;678;2;680;NA;136515;9;2021-08-10;84010
2021-08-09;"Banskobystrický kraj";9;1064;0;1064;NA;136515;9;2021-08-09;84001
2021-08-08;"Banskobystrický kraj";4;335;1;336;NA;136515;5;2021-08-08;83992
2021-08-07;"Banskobystrický kraj";0;308;4;312;NA;136515;4;2021-08-07;83987
2021-08-06;"Banskobystrický kraj";5;929;2;931;NA;136515;7;2021-08-06;83983
2021-08-05;"Banskobystrický kraj";2;838;1;839;NA;136515;3;2021-08-05;83976
2021-08-04;"Banskobystrický kraj";2;579;1;580;NA;136515;3;2021-08-04;83973
2021-08-03;"Banskobystrický kraj";4;743;0;743;NA;136515;4;2021-08-03;83970
2021-08-02;"Banskobystrický kraj";6;934;0;934;NA;136515;6;2021-08-02;83966
2021-08-01;"Banskobystrický kraj";0;271;0;271;NA;136515;0;2021-08-01;83960
2021-07-31;"Banskobystrický kraj";1;370;4;374;NA;136515;5;2021-07-31;83960
2021-07-30;"Banskobystrický kraj";27;928;2;930;NA;136515;29;2021-07-30;83955
2021-07-29;"Banskobystrický kraj";2;890;1;891;NA;136515;3;2021-07-29;83926
2021-07-28;"Banskobystrický kraj";4;520;1;521;NA;136515;5;2021-07-28;83923
2021-07-27;"Banskobystrický kraj";15;1092;0;1092;NA;136515;15;2021-07-27;83918
2021-07-26;"Banskobystrický kraj";2;911;1;912;NA;136515;3;2021-07-26;83903
2021-07-25;"Banskobystrický kraj";0;367;1;368;NA;136515;1;2021-07-25;83900
2021-07-24;"Banskobystrický kraj";2;298;0;298;NA;136515;2;2021-07-24;83899
2021-07-23;"Banskobystrický kraj";7;840;0;840;NA;136515;7;2021-07-23;83897
2021-07-22;"Banskobystrický kraj";5;727;3;730;NA;136515;8;2021-07-22;83890
2021-07-21;"Banskobystrický kraj";2;560;0;560;NA;136515;2;2021-07-21;83882
2021-07-20;"Banskobystrický kraj";6;885;2;887;NA;136515;8;2021-07-20;83880
2021-07-19;"Banskobystrický kraj";1;854;3;857;NA;136515;4;2021-07-19;83872
2021-07-18;"Banskobystrický kraj";0;377;1;378;NA;136515;1;2021-07-18;83868
2021-07-17;"Banskobystrický kraj";1;324;0;324;NA;136515;1;2021-07-17;83867
2021-07-16;"Banskobystrický kraj";3;974;1;975;NA;136515;4;2021-07-16;83866
2021-07-15;"Banskobystrický kraj";1;1038;0;1038;NA;136515;1;2021-07-15;83862
2021-07-14;"Banskobystrický kraj";3;765;0;765;NA;136515;3;2021-07-14;83861
2021-07-13;"Banskobystrický kraj";2;695;0;695;NA;136515;2;2021-07-13;83858
2021-07-12;"Banskobystrický kraj";1;1057;0;1057;NA;136515;1;2021-07-12;83856
2021-07-11;"Banskobystrický kraj";0;446;0;446;NA;136515;0;2021-07-11;83855
2021-07-10;"Banskobystrický kraj";2;368;0;368;NA;136515;2;2021-07-10;83855
2021-07-09;"Banskobystrický kraj";3;1209;0;1209;NA;136515;3;2021-07-09;83853
2021-07-08;"Banskobystrický kraj";0;1083;1;1084;NA;136515;1;2021-07-08;83850
2021-07-07;"Banskobystrický kraj";1;798;0;798;NA;136515;1;2021-07-07;83849
2021-07-06;"Banskobystrický kraj";6;1365;0;1365;NA;136515;6;2021-07-06;83848
2021-07-05;"Banskobystrický kraj";2;392;1;393;NA;136515;3;2021-07-05;83842
2021-07-04;"Banskobystrický kraj";0;318;0;318;NA;136515;0;2021-07-04;83839
2021-07-03;"Banskobystrický kraj";1;413;1;414;NA;136515;2;2021-07-03;83839
2021-07-02;"Banskobystrický kraj";3;1045;0;1045;NA;136515;3;2021-07-02;83837
2021-07-01;"Banskobystrický kraj";0;705;1;706;NA;136515;1;2021-07-01;83834
2021-06-30;"Banskobystrický kraj";3;7607;1;7608;NA;136515;4;2021-06-30;83833
2021-06-29;"Banskobystrický kraj";2;4642;1;4643;NA;136515;3;2021-06-29;83829
2021-06-28;"Banskobystrický kraj";3;5695;1;5696;NA;136515;4;2021-06-28;83826
2021-06-27;"Banskobystrický kraj";0;4369;5;4374;NA;136515;5;2021-06-27;83822
2021-06-26;"Banskobystrický kraj";0;4289;4;4293;NA;136515;4;2021-06-26;83817
2021-06-25;"Banskobystrický kraj";2;6717;2;6719;NA;136515;4;2021-06-25;83813
2021-06-24;"Banskobystrický kraj";6;4585;2;4587;NA;136515;8;2021-06-24;83809
2021-06-23;"Banskobystrický kraj";4;4947;0;4947;NA;136515;4;2021-06-23;83801
2021-06-22;"Banskobystrický kraj";7;4527;0;4527;NA;136515;7;2021-06-22;83797
2021-06-21;"Banskobystrický kraj";6;5836;8;5844;NA;136515;14;2021-06-21;83790
2021-06-20;"Banskobystrický kraj";0;5055;7;5062;NA;136515;7;2021-06-20;83776
2021-06-19;"Banskobystrický kraj";0;5639;4;5643;NA;136515;4;2021-06-19;83769
2021-06-18;"Banskobystrický kraj";4;7642;1;7643;NA;136515;5;2021-06-18;83765
2021-06-17;"Banskobystrický kraj";2;5245;3;5248;NA;136515;5;2021-06-17;83760
2021-06-16;"Banskobystrický kraj";10;5951;5;5956;NA;136515;15;2021-06-16;83755
2021-06-15;"Banskobystrický kraj";9;5576;6;5582;NA;136515;15;2021-06-15;83740
2021-06-14;"Banskobystrický kraj";8;6922;7;6929;NA;136515;15;2021-06-14;83725
2021-06-13;"Banskobystrický kraj";0;6407;7;6414;NA;136515;7;2021-06-13;83710
2021-06-12;"Banskobystrický kraj";3;6338;6;6344;NA;136515;9;2021-06-12;83703
2021-06-11;"Banskobystrický kraj";5;9693;15;9708;NA;136515;20;2021-06-11;83694
2021-06-10;"Banskobystrický kraj";10;5726;8;5734;NA;136515;18;2021-06-10;83674
2021-06-09;"Banskobystrický kraj";9;5720;4;5724;NA;136515;13;2021-06-09;83656
2021-06-08;"Banskobystrický kraj";15;5645;10;5655;NA;136515;25;2021-06-08;83643
2021-06-07;"Banskobystrický kraj";4;7582;21;7603;NA;136515;25;2021-06-07;83618
2021-06-06;"Banskobystrický kraj";1;7497;12;7509;NA;136515;13;2021-06-06;83593
2021-06-05;"Banskobystrický kraj";15;7531;9;7540;NA;136515;24;2021-06-05;83580
2021-06-04;"Banskobystrický kraj";2;9352;14;9366;NA;136515;16;2021-06-04;83556
2021-06-03;"Banskobystrický kraj";8;6507;24;6531;NA;136515;32;2021-06-03;83540
2021-06-02;"Banskobystrický kraj";7;6837;6;6843;NA;136515;13;2021-06-02;83508
2021-06-01;"Banskobystrický kraj";12;7146;14;7160;NA;136515;26;2021-06-01;83495
2021-05-31;"Banskobystrický kraj";4;9546;31;9577;NA;136515;35;2021-05-31;83469
2021-05-30;"Banskobystrický kraj";3;8959;19;8978;NA;136515;22;2021-05-30;83434
2021-05-29;"Banskobystrický kraj";11;9763;18;9781;NA;136515;29;2021-05-29;83412
2021-05-28;"Banskobystrický kraj";13;11905;27;11932;NA;136515;40;2021-05-28;83383
2021-05-27;"Banskobystrický kraj";7;8760;12;8772;NA;136515;19;2021-05-27;83343
2021-05-26;"Banskobystrický kraj";18;7905;17;7922;NA;136515;35;2021-05-26;83324
2021-05-25;"Banskobystrický kraj";27;8951;30;8981;NA;136515;57;2021-05-25;83289
2021-05-24;"Banskobystrický kraj";9;12469;44;12513;NA;136515;53;2021-05-24;83232
2021-05-23;"Banskobystrický kraj";0;9798;27;9825;NA;136515;27;2021-05-23;83179
2021-05-22;"Banskobystrický kraj";20;9608;26;9634;NA;136515;46;2021-05-22;83152
2021-05-21;"Banskobystrický kraj";22;12796;25;12821;NA;136515;47;2021-05-21;83106
2021-05-20;"Banskobystrický kraj";14;8994;25;9019;NA;136515;39;2021-05-20;83059
2021-05-19;"Banskobystrický kraj";42;8608;21;8629;NA;136515;63;2021-05-19;83020
2021-05-18;"Banskobystrický kraj";27;9450;25;9475;NA;136515;52;2021-05-18;82957
2021-05-17;"Banskobystrický kraj";11;13399;33;13432;NA;136515;44;2021-05-17;82905
2021-05-16;"Banskobystrický kraj";15;14072;26;14098;NA;136515;41;2021-05-16;82861
2021-05-15;"Banskobystrický kraj";11;15356;29;15385;NA;136515;40;2021-05-15;82820
2021-05-14;"Banskobystrický kraj";35;18939;45;18984;NA;136515;80;2021-05-14;82780
2021-05-13;"Banskobystrický kraj";37;10605;40;10645;NA;136515;77;2021-05-13;82700
2021-05-12;"Banskobystrický kraj";31;10857;45;10902;NA;136515;76;2021-05-12;82623
2021-05-11;"Banskobystrický kraj";42;11325;48;11373;NA;136515;90;2021-05-11;82547
2021-05-10;"Banskobystrický kraj";28;17621;68;17689;NA;136515;96;2021-05-10;82457
2021-05-09;"Banskobystrický kraj";25;21902;68;21970;NA;136515;93;2021-05-09;82361
2021-05-08;"Banskobystrický kraj";11;14285;26;14311;NA;136515;37;2021-05-08;82268
2021-05-07;"Banskobystrický kraj";41;21806;78;21884;NA;136515;119;2021-05-07;82231
2021-05-06;"Banskobystrický kraj";36;12251;70;12321;NA;136515;106;2021-05-06;82112
2021-05-05;"Banskobystrický kraj";34;12592;63;12655;NA;136515;97;2021-05-05;82006
2021-05-04;"Banskobystrický kraj";83;13888;47;13935;NA;136515;130;2021-05-04;81909
2021-05-03;"Banskobystrický kraj";30;20872;80;20952;NA;136515;110;2021-05-03;81779
2021-05-02;"Banskobystrický kraj";6;33040;60;33100;NA;136515;66;2021-05-02;81669
2021-05-01;"Banskobystrický kraj";54;36900;67;36967;NA;136515;121;2021-05-01;81603
2021-04-30;"Banskobystrický kraj";38;34957;86;35043;NA;136515;124;2021-04-30;81482
2021-04-29;"Banskobystrický kraj";55;16839;68;16907;NA;136515;123;2021-04-29;81358
2021-04-28;"Banskobystrický kraj";66;17959;67;18026;NA;136515;133;2021-04-28;81235
2021-04-27;"Banskobystrický kraj";70;19152;73;19225;NA;136515;143;2021-04-27;81102
2021-04-26;"Banskobystrický kraj";34;28517;101;28618;NA;136515;135;2021-04-26;80959
2021-04-25;"Banskobystrický kraj";14;40601;106;40707;NA;136515;120;2021-04-25;80824
2021-04-24;"Banskobystrický kraj";40;51944;98;52042;NA;136515;138;2021-04-24;80704
2021-04-23;"Banskobystrický kraj";78;37922;88;38010;NA;136515;166;2021-04-23;80566
2021-04-22;"Banskobystrický kraj";51;17415;57;17472;NA;136515;108;2021-04-22;80400
2021-04-21;"Banskobystrický kraj";76;19218;94;19312;NA;136515;170;2021-04-21;80292
2021-04-20;"Banskobystrický kraj";116;21234;98;21332;NA;136515;214;2021-04-20;80122
2021-04-19;"Banskobystrický kraj";48;31408;105;31513;NA;136515;153;2021-04-19;79908
2021-04-18;"Banskobystrický kraj";16;43375;90;43465;NA;136515;106;2021-04-18;79755
2021-04-17;"Banskobystrický kraj";42;64939;92;65031;NA;136515;134;2021-04-17;79649
2021-04-16;"Banskobystrický kraj";72;37307;100;37407;NA;136515;172;2021-04-16;79515
2021-04-15;"Banskobystrický kraj";67;20127;83;20210;NA;136515;150;2021-04-15;79343
2021-04-14;"Banskobystrický kraj";69;21260;86;21346;NA;136515;155;2021-04-14;79193
2021-04-13;"Banskobystrický kraj";130;23076;77;23153;NA;136515;207;2021-04-13;79038
2021-04-12;"Banskobystrický kraj";60;32272;130;32402;NA;136515;190;2021-04-12;78831
2021-04-11;"Banskobystrický kraj";0;41367;88;41455;NA;136515;88;2021-04-11;78641
2021-04-10;"Banskobystrický kraj";56;64728;141;64869;NA;136515;197;2021-04-10;78553
2021-04-09;"Banskobystrický kraj";106;31570;118;31688;NA;136515;224;2021-04-09;78356
2021-04-08;"Banskobystrický kraj";132;19000;148;19148;NA;136515;280;2021-04-08;78132
2021-04-07;"Banskobystrický kraj";226;25121;94;25215;NA;136515;320;2021-04-07;77852
2021-04-06;"Banskobystrický kraj";93;42496;187;42683;NA;136515;280;2021-04-06;77532
2021-04-05;"Banskobystrický kraj";15;11797;87;11884;NA;136515;102;2021-04-05;77252
2021-04-04;"Banskobystrický kraj";24;19683;79;19762;NA;136515;103;2021-04-04;77150
2021-04-03;"Banskobystrický kraj";5;72553;211;72764;NA;136515;216;2021-04-03;77047
2021-04-02;"Banskobystrický kraj";71;13455;66;13521;NA;136515;137;2021-04-02;76831
2021-04-01;"Banskobystrický kraj";171;39407;200;39607;NA;136515;371;2021-04-01;76694
2021-03-31;"Banskobystrický kraj";147;25543;161;25704;NA;136515;308;2021-03-31;76323
2021-03-30;"Banskobystrický kraj";167;21442;159;21601;NA;136515;326;2021-03-30;76015
2021-03-29;"Banskobystrický kraj";119;29491;218;29709;NA;136515;337;2021-03-29;75689
2021-03-28;"Banskobystrický kraj";25;40610;189;40799;NA;136515;214;2021-03-28;75352
2021-03-27;"Banskobystrický kraj";85;63414;260;63674;NA;136515;345;2021-03-27;75138
2021-03-26;"Banskobystrický kraj";122;43671;240;43911;NA;136515;362;2021-03-26;74793
2021-03-25;"Banskobystrický kraj";120;21598;240;21838;NA;136515;360;2021-03-25;74431
2021-03-24;"Banskobystrický kraj";200;19336;227;19563;NA;136515;427;2021-03-24;74071
2021-03-23;"Banskobystrický kraj";241;21540;257;21797;NA;136515;498;2021-03-23;73644
2021-03-22;"Banskobystrický kraj";65;30480;274;30754;NA;136515;339;2021-03-22;73146
2021-03-21;"Banskobystrický kraj";31;40039;280;40319;NA;136515;311;2021-03-21;72807
2021-03-20;"Banskobystrický kraj";119;67926;383;68309;NA;136515;502;2021-03-20;72496
2021-03-19;"Banskobystrický kraj";240;44036;306;44342;NA;136515;546;2021-03-19;71994
2021-03-18;"Banskobystrický kraj";160;22467;273;22740;NA;136515;433;2021-03-18;71448
2021-03-17;"Banskobystrický kraj";262;21573;245;21818;NA;136515;507;2021-03-17;71015
2021-03-16;"Banskobystrický kraj";340;23349;224;23573;NA;136515;564;2021-03-16;70508
2021-03-15;"Banskobystrický kraj";95;32306;366;32672;NA;136515;461;2021-03-15;69944
2021-03-14;"Banskobystrický kraj";39;39212;218;39430;NA;136515;257;2021-03-14;69483
2021-03-13;"Banskobystrický kraj";209;67463;395;67858;NA;136515;604;2021-03-13;69226
2021-03-12;"Banskobystrický kraj";206;41442;330;41772;NA;136515;536;2021-03-12;68622
2021-03-11;"Banskobystrický kraj";228;21337;274;21611;NA;136515;502;2021-03-11;68086
2021-03-10;"Banskobystrický kraj";260;20399;238;20637;NA;136515;498;2021-03-10;67584
2021-03-09;"Banskobystrický kraj";352;21790;284;22074;NA;136515;636;2021-03-09;67086
2021-03-08;"Banskobystrický kraj";191;31468;427;31895;NA;136515;618;2021-03-08;66450
2021-03-07;"Banskobystrický kraj";60;39191;295;39486;NA;136515;355;2021-03-07;65832
2021-03-06;"Banskobystrický kraj";164;70895;410;71305;NA;136515;574;2021-03-06;65477
2021-03-05;"Banskobystrický kraj";221;42336;389;42725;NA;136515;610;2021-03-05;64903
2021-03-04;"Banskobystrický kraj";226;22007;334;22341;NA;136515;560;2021-03-04;64293
2021-03-03;"Banskobystrický kraj";317;21949;331;22280;NA;136515;648;2021-03-03;63733
2021-03-02;"Banskobystrický kraj";291;23160;354;23514;NA;136515;645;2021-03-02;63085
2021-03-01;"Banskobystrický kraj";151;31773;434;32207;NA;136515;585;2021-03-01;62440
2021-02-28;"Banskobystrický kraj";45;38663;336;38999;NA;136515;381;2021-02-28;61855
2021-02-27;"Banskobystrický kraj";289;66667;529;67196;NA;136515;818;2021-02-27;61474
2021-02-26;"Banskobystrický kraj";326;39670;468;40138;NA;136515;794;2021-02-26;60656
2021-02-25;"Banskobystrický kraj";375;18081;366;18447;NA;136515;741;2021-02-25;59862
2021-02-24;"Banskobystrický kraj";332;16735;373;17108;NA;136515;705;2021-02-24;59121
2021-02-23;"Banskobystrický kraj";462;19932;439;20371;NA;136515;901;2021-02-23;58416
2021-02-22;"Banskobystrický kraj";67;28643;598;29241;NA;136515;665;2021-02-22;57515
2021-02-21;"Banskobystrický kraj";68;37619;444;38063;NA;136515;512;2021-02-21;56850
2021-02-20;"Banskobystrický kraj";280;68851;598;69449;NA;136515;878;2021-02-20;56338
2021-02-19;"Banskobystrický kraj";420;39888;511;40399;NA;136515;931;2021-02-19;55460
2021-02-18;"Banskobystrický kraj";241;18618;396;19014;NA;136515;637;2021-02-18;54529
2021-02-17;"Banskobystrický kraj";415;16740;389;17129;NA;136515;804;2021-02-17;53892
2021-02-16;"Banskobystrický kraj";338;19731;368;20099;NA;136515;706;2021-02-16;53088
2021-02-15;"Banskobystrický kraj";118;35835;591;36426;NA;136515;709;2021-02-15;52382
2021-02-14;"Banskobystrický kraj";60;31894;386;32280;NA;136515;446;2021-02-14;51673
2021-02-13;"Banskobystrický kraj";202;53889;492;54381;NA;136515;694;2021-02-13;51227
2021-02-12;"Banskobystrický kraj";312;37270;533;37803;NA;136515;845;2021-02-12;50533
2021-02-11;"Banskobystrický kraj";305;21200;386;21586;NA;136515;691;2021-02-11;49688
2021-02-10;"Banskobystrický kraj";333;14790;344;15134;NA;136515;677;2021-02-10;48997
2021-02-09;"Banskobystrický kraj";329;18504;362;18866;NA;136515;691;2021-02-09;48320
2021-02-08;"Banskobystrický kraj";103;49716;695;50411;NA;136515;798;2021-02-08;47629
2021-02-07;"Banskobystrický kraj";70;37659;335;37994;NA;136515;405;2021-02-07;46831
2021-02-06;"Banskobystrický kraj";178;69388;570;69958;NA;136515;748;2021-02-06;46426
2021-02-05;"Banskobystrický kraj";282;24577;363;24940;NA;136515;645;2021-02-05;45678
2021-02-04;"Banskobystrický kraj";240;14367;430;14797;NA;136515;670;2021-02-04;45033
2021-02-03;"Banskobystrický kraj";350;9459;255;9714;NA;136515;605;2021-02-03;44363
2021-02-02;"Banskobystrický kraj";277;15741;334;16075;NA;136515;611;2021-02-02;43758
2021-02-01;"Banskobystrický kraj";75;24346;489;24835;NA;136515;564;2021-02-01;43147
2021-01-31;"Banskobystrický kraj";34;19983;201;20184;NA;136515;235;2021-01-31;42583
2021-01-30;"Banskobystrický kraj";163;63896;525;64421;NA;136515;688;2021-01-30;42348
2021-01-29;"Banskobystrický kraj";196;17368;274;17642;NA;136515;470;2021-01-29;41660
2021-01-28;"Banskobystrický kraj";218;15613;382;15995;NA;136515;600;2021-01-28;41190
2021-01-27;"Banskobystrický kraj";191;8132;200;8332;NA;136515;391;2021-01-27;40590
2021-01-26;"Banskobystrický kraj";238;19795;283;20078;NA;136515;521;2021-01-26;40199
2021-01-25;"Banskobystrický kraj";82;33666;412;34078;NA;136515;494;2021-01-25;39678
2021-01-24;"Banskobystrický kraj";38;35587;278;35865;NA;136515;316;2021-01-24;39184
2021-01-23;"Banskobystrický kraj";142;89058;523;89581;NA;136515;665;2021-01-23;38868
2021-01-22;"Banskobystrický kraj";175;25887;355;26242;NA;136515;530;2021-01-22;38203
2021-01-21;"Banskobystrický kraj";194;17063;279;17342;NA;136515;473;2021-01-21;37673
2021-01-20;"Banskobystrický kraj";231;9142;186;9328;NA;136515;417;2021-01-20;37200
2021-01-19;"Banskobystrický kraj";213;10708;311;11019;NA;136515;524;2021-01-19;36783
2021-01-18;"Banskobystrický kraj";94;7402;401;7803;NA;136515;495;2021-01-18;36259
2021-01-17;"Banskobystrický kraj";110;8154;77;8231;NA;136515;187;2021-01-17;35764
2021-01-16;"Banskobystrický kraj";58;2274;57;2331;NA;136515;115;2021-01-16;35577
2021-01-15;"Banskobystrický kraj";164;7673;217;7890;NA;136515;381;2021-01-15;35462
2021-01-14;"Banskobystrický kraj";220;5760;325;6085;NA;136515;545;2021-01-14;35081
2021-01-13;"Banskobystrický kraj";235;5974;217;6191;NA;136515;452;2021-01-13;34536
2021-01-12;"Banskobystrický kraj";194;6600;290;6890;NA;136515;484;2021-01-12;34084
2021-01-11;"Banskobystrický kraj";76;8231;481;8712;NA;136515;557;2021-01-11;33600
2021-01-10;"Banskobystrický kraj";110;433;4;437;NA;136515;114;2021-01-10;33043
2021-01-09;"Banskobystrický kraj";297;2378;81;2459;NA;136515;378;2021-01-09;32929
2021-01-08;"Banskobystrický kraj";435;9805;443;10248;NA;136515;878;2021-01-08;32551
2021-01-07;"Banskobystrický kraj";127;6322;366;6688;NA;136515;493;2021-01-07;31673
2021-01-06;"Banskobystrický kraj";305;3374;185;3559;NA;136515;490;2021-01-06;31180
2021-01-05;"Banskobystrický kraj";372;7349;533;7882;NA;136515;905;2021-01-05;30690
2021-01-04;"Banskobystrický kraj";130;7087;700;7787;NA;136515;830;2021-01-04;29785
2021-01-03;"Banskobystrický kraj";199;320;19;339;NA;136515;218;2021-01-03;28955
2021-01-02;"Banskobystrický kraj";123;702;85;787;NA;136515;208;2021-01-02;28737
2021-01-01;"Banskobystrický kraj";220;1958;132;2090;NA;136515;352;2021-01-01;28529
2020-12-31;"Banskobystrický kraj";499;7679;633;8312;NA;136515;1132;2020-12-31;28177
2020-12-30;"Banskobystrický kraj";593;7407;541;7948;NA;136515;1134;2020-12-30;27045
2020-12-29;"Banskobystrický kraj";240;7876;660;8536;NA;136515;900;2020-12-29;25911
2020-12-28;"Banskobystrický kraj";131;6120;720;6840;NA;136515;851;2020-12-28;25011
2020-12-27;"Banskobystrický kraj";116;541;25;566;NA;136515;141;2020-12-27;24160
2020-12-26;"Banskobystrický kraj";61;295;35;330;NA;136515;96;2020-12-26;24019
2020-12-25;"Banskobystrický kraj";65;888;10;898;NA;136515;75;2020-12-25;23923
2020-12-24;"Banskobystrický kraj";452;3685;135;3820;NA;136515;587;2020-12-24;23848
2020-12-23;"Banskobystrický kraj";368;9892;473;10365;NA;136515;841;2020-12-23;23261
2020-12-22;"Banskobystrický kraj";307;8468;619;9087;NA;136515;926;2020-12-22;22420
2020-12-21;"Banskobystrický kraj";286;4922;455;5377;NA;136515;741;2020-12-21;21494
2020-12-20;"Banskobystrický kraj";155;249;14;263;NA;136515;169;2020-12-20;20753
2020-12-19;"Banskobystrický kraj";170;3084;138;3222;NA;136515;308;2020-12-19;20584
2020-12-18;"Banskobystrický kraj";432;5959;331;6290;NA;136515;763;2020-12-18;20276
2020-12-17;"Banskobystrický kraj";468;8753;653;9406;NA;136515;1121;2020-12-17;19513
2020-12-16;"Banskobystrický kraj";379;10184;567;10751;NA;136515;946;2020-12-16;18392
2020-12-15;"Banskobystrický kraj";336;5281;425;5706;NA;136515;761;2020-12-15;17446
2020-12-14;"Banskobystrický kraj";148;4012;259;4271;NA;136515;407;2020-12-14;16685
2020-12-13;"Banskobystrický kraj";122;142;1;143;NA;136515;123;2020-12-13;16278
2020-12-12;"Banskobystrický kraj";137;2714;138;2852;NA;136515;275;2020-12-12;16155
2020-12-11;"Banskobystrický kraj";468;6633;362;6995;NA;136515;830;2020-12-11;15880
2020-12-10;"Banskobystrický kraj";280;5501;369;5870;NA;136515;649;2020-12-10;15050
2020-12-09;"Banskobystrický kraj";323;3941;205;4146;NA;136515;528;2020-12-09;14401
2020-12-08;"Banskobystrický kraj";256;3782;272;4054;NA;136515;528;2020-12-08;13873
2020-12-07;"Banskobystrický kraj";175;2633;177;2810;NA;136515;352;2020-12-07;13345
2020-12-06;"Banskobystrický kraj";121;507;11;518;NA;136515;132;2020-12-06;12993
2020-12-05;"Banskobystrický kraj";109;1099;34;1133;NA;136515;143;2020-12-05;12861
2020-12-04;"Banskobystrický kraj";339;3828;174;4002;NA;136515;513;2020-12-04;12718
2020-12-03;"Banskobystrický kraj";240;3193;234;3427;NA;136515;474;2020-12-03;12205
2020-12-02;"Banskobystrický kraj";217;4442;186;4628;NA;136515;403;2020-12-02;11731
2020-12-01;"Banskobystrický kraj";215;2702;134;2836;NA;136515;349;2020-12-01;11328
2020-11-30;"Banskobystrický kraj";74;4314;241;4555;NA;136515;315;2020-11-30;10979
2020-11-29;"Banskobystrický kraj";19;208;7;215;NA;136515;26;2020-11-29;10664
2020-11-28;"Banskobystrický kraj";81;1408;55;1463;NA;136515;136;2020-11-28;10638
2020-11-27;"Banskobystrický kraj";219;2566;123;2689;NA;136515;342;2020-11-27;10502
2020-11-26;"Banskobystrický kraj";208;2124;93;2217;NA;136515;301;2020-11-26;10160
2020-11-25;"Banskobystrický kraj";170;1952;86;2038;NA;136515;256;2020-11-25;9859
2020-11-24;"Banskobystrický kraj";166;2566;69;2635;NA;136515;235;2020-11-24;9603
2020-11-23;"Banskobystrický kraj";66;10147;193;10340;NA;136515;259;2020-11-23;9368
2020-11-22;"Banskobystrický kraj";38;104;1;105;NA;136515;39;2020-11-22;9109
2020-11-21;"Banskobystrický kraj";52;904;14;918;NA;136515;66;2020-11-21;9070
2020-11-20;"Banskobystrický kraj";127;2005;107;2112;NA;136515;234;2020-11-20;9004
2020-11-19;"Banskobystrický kraj";170;1218;82;1300;NA;136515;252;2020-11-19;8770
2020-11-18;"Banskobystrický kraj";153;698;65;763;NA;136515;218;2020-11-18;8518
2020-11-17;"Banskobystrický kraj";52;578;35;613;NA;136515;87;2020-11-17;8300
2020-11-16;"Banskobystrický kraj";106;470;25;495;NA;136515;131;2020-11-16;8213
2020-11-15;"Banskobystrický kraj";52;301;4;305;NA;136515;56;2020-11-15;8082
2020-11-14;"Banskobystrický kraj";73;305;2;307;NA;136515;75;2020-11-14;8026
2020-11-13;"Banskobystrický kraj";157;552;11;563;NA;136515;168;2020-11-13;7951
2020-11-12;"Banskobystrický kraj";218;952;44;996;NA;136515;262;2020-11-12;7783
2020-11-11;"Banskobystrický kraj";224;437;9;446;NA;136515;233;2020-11-11;7521
2020-11-10;"Banskobystrický kraj";263;463;18;481;NA;136515;281;2020-11-10;7288
2020-11-09;"Banskobystrický kraj";80;2678;31;2709;NA;136515;111;2020-11-09;7007
2020-11-08;"Banskobystrický kraj";82;981;16;997;NA;136515;98;2020-11-08;6896
2020-11-07;"Banskobystrický kraj";164;8828;94;8922;NA;136515;258;2020-11-07;6798
2020-11-06;"Banskobystrický kraj";227;2496;16;2512;NA;136515;243;2020-11-06;6540
2020-11-05;"Banskobystrický kraj";240;290;33;323;NA;136515;273;2020-11-05;6297
2020-11-04;"Banskobystrický kraj";254;1366;13;1379;NA;136515;267;2020-11-04;6024
2020-11-03;"Banskobystrický kraj";246;1332;4;1336;NA;136515;250;2020-11-03;5757
2020-11-02;"Banskobystrický kraj";90;2909;65;2974;NA;136515;155;2020-11-02;5507
2020-11-01;"Banskobystrický kraj";101;2671;42;2713;NA;136515;143;2020-11-01;5352
2020-10-31;"Banskobystrický kraj";199;13516;116;13632;NA;136515;315;2020-10-31;5209
2020-10-30;"Banskobystrický kraj";254;2829;20;2849;NA;136515;274;2020-10-30;4894
2020-10-29;"Banskobystrický kraj";372;969;42;1011;NA;136515;414;2020-10-29;4620
2020-10-28;"Banskobystrický kraj";285;302;30;332;NA;136515;315;2020-10-28;4206
2020-10-27;"Banskobystrický kraj";266;654;40;694;NA;136515;306;2020-10-27;3891
2020-10-26;"Banskobystrický kraj";38;234;29;263;NA;136515;67;2020-10-26;3585
2020-10-25;"Banskobystrický kraj";50;140;11;151;NA;136515;61;2020-10-25;3518
2020-10-24;"Banskobystrický kraj";315;114;12;126;NA;136515;327;2020-10-24;3457
2020-10-23;"Banskobystrický kraj";231;230;29;259;NA;136515;260;2020-10-23;3130
2020-10-22;"Banskobystrický kraj";264;253;24;277;NA;136515;288;2020-10-22;2870
2020-10-21;"Banskobystrický kraj";209;266;3;269;NA;136515;212;2020-10-21;2582
2020-10-20;"Banskobystrický kraj";210;66;3;69;NA;136515;213;2020-10-20;2370
2020-10-19;"Banskobystrický kraj";27;73;12;85;NA;136515;39;2020-10-19;2157
2020-10-18;"Banskobystrický kraj";49;0;0;0;NA;136515;49;2020-10-18;2118
2020-10-17;"Banskobystrický kraj";91;0;0;0;NA;136515;91;2020-10-17;2069
2020-10-16;"Banskobystrický kraj";224;37;3;40;NA;136515;227;2020-10-16;1978
2020-10-15;"Banskobystrický kraj";133;29;1;30;NA;136515;134;2020-10-15;1751
2020-10-14;"Banskobystrický kraj";139;31;1;32;NA;136515;140;2020-10-14;1617
2020-10-13;"Banskobystrický kraj";151;169;11;180;NA;136515;162;2020-10-13;1477
2020-10-12;"Banskobystrický kraj";11;110;4;114;NA;136515;15;2020-10-12;1315
2020-10-11;"Banskobystrický kraj";14;0;0;0;NA;136515;14;2020-10-11;1300
2020-10-10;"Banskobystrický kraj";53;0;0;0;NA;136515;53;2020-10-10;1286
2020-10-09;"Banskobystrický kraj";128;0;0;0;NA;136515;128;2020-10-09;1233
2020-10-08;"Banskobystrický kraj";99;0;0;0;NA;136515;99;2020-10-08;1105
2020-10-07;"Banskobystrický kraj";124;0;0;0;NA;136515;124;2020-10-07;1006
2020-10-06;"Banskobystrický kraj";68;0;0;0;NA;136515;68;2020-10-06;882
2020-10-05;"Banskobystrický kraj";49;0;0;0;NA;136515;49;2020-10-05;814
2020-10-04;"Banskobystrický kraj";8;0;0;0;NA;136515;8;2020-10-04;765
2020-10-03;"Banskobystrický kraj";37;0;0;0;NA;136515;37;2020-10-03;757
2020-10-02;"Banskobystrický kraj";74;0;0;0;NA;136515;74;2020-10-02;720
2020-10-01;"Banskobystrický kraj";49;16;0;16;NA;136515;49;2020-10-01;646
2020-09-30;"Banskobystrický kraj";60;0;0;0;NA;136515;60;2020-09-30;597
2020-09-29;"Banskobystrický kraj";24;0;0;0;NA;136515;24;2020-09-29;537
2020-09-28;"Banskobystrický kraj";0;0;0;0;NA;136515;0;2020-09-28;513
2020-09-27;"Banskobystrický kraj";20;0;0;0;NA;136515;20;2020-09-27;513
2020-09-26;"Banskobystrický kraj";24;0;0;0;NA;136515;24;2020-09-26;493
2020-09-25;"Banskobystrický kraj";29;0;0;0;NA;136515;29;2020-09-25;469
2020-09-24;"Banskobystrický kraj";25;0;0;0;NA;136515;25;2020-09-24;440
2020-09-23;"Banskobystrický kraj";17;0;0;0;NA;136515;17;2020-09-23;415
2020-09-22;"Banskobystrický kraj";25;0;0;0;NA;136515;25;2020-09-22;398
2020-09-21;"Banskobystrický kraj";3;0;0;0;NA;136515;3;2020-09-21;373
2020-09-20;"Banskobystrický kraj";0;0;0;0;NA;136515;0;2020-09-20;370
2020-09-19;"Banskobystrický kraj";3;0;0;0;NA;136515;3;2020-09-19;370
2020-09-18;"Banskobystrický kraj";24;0;0;0;NA;136515;24;2020-09-18;367
2020-09-17;"Banskobystrický kraj";14;0;0;0;NA;136515;14;2020-09-17;343
2020-09-16;"Banskobystrický kraj";6;0;0;0;NA;136515;6;2020-09-16;329
2020-09-15;"Banskobystrický kraj";2;0;0;0;NA;136515;2;2020-09-15;323
2020-09-14;"Banskobystrický kraj";13;0;0;0;NA;136515;13;2020-09-14;321
2020-09-13;"Banskobystrický kraj";1;0;0;0;NA;136515;1;2020-09-13;308
2020-09-12;"Banskobystrický kraj";5;0;0;0;NA;136515;5;2020-09-12;307
2020-09-11;"Banskobystrický kraj";19;0;0;0;NA;136515;19;2020-09-11;302
2020-09-10;"Banskobystrický kraj";11;0;0;0;NA;136515;11;2020-09-10;283
2020-09-09;"Banskobystrický kraj";13;0;0;0;NA;136515;13;2020-09-09;272
2020-09-08;"Banskobystrický kraj";5;0;0;0;NA;136515;5;2020-09-08;259
2020-09-07;"Banskobystrický kraj";2;0;0;0;NA;136515;2;2020-09-07;254
2020-09-06;"Banskobystrický kraj";0;0;0;0;NA;136515;0;2020-09-06;252
2020-09-05;"Banskobystrický kraj";0;0;0;0;NA;136515;0;2020-09-05;252
2020-09-04;"Banskobystrický kraj";9;0;0;0;NA;136515;9;2020-09-04;252
2020-09-03;"Banskobystrický kraj";5;0;0;0;NA;136515;5;2020-09-03;243
2020-09-02;"Banskobystrický kraj";6;0;0;0;NA;136515;6;2020-09-02;238
2020-09-01;"Banskobystrický kraj";2;0;0;0;NA;136515;2;2020-09-01;232
2020-08-31;"Banskobystrický kraj";6;0;0;0;NA;136515;6;2020-08-31;230
2020-08-30;"Banskobystrický kraj";0;0;0;0;NA;136515;0;2020-08-30;224
2020-08-29;"Banskobystrický kraj";1;0;0;0;NA;136515;1;2020-08-29;224
2020-08-28;"Banskobystrický kraj";3;0;0;0;NA;136515;3;2020-08-28;223
2020-08-27;"Banskobystrický kraj";1;0;0;0;NA;136515;1;2020-08-27;220
2020-08-26;"Banskobystrický kraj";2;0;0;0;NA;136515;2;2020-08-26;219
2020-08-25;"Banskobystrický kraj";2;0;0;0;NA;136515;2;2020-08-25;217
2020-08-24;"Banskobystrický kraj";0;0;0;0;NA;136515;0;2020-08-24;215
2020-08-23;"Banskobystrický kraj";0;0;0;0;NA;136515;0;2020-08-23;215
2020-08-22;"Banskobystrický kraj";0;0;0;0;NA;136515;0;2020-08-22;215
2020-08-21;"Banskobystrický kraj";4;0;0;0;NA;136515;4;2020-08-21;215
2020-08-20;"Banskobystrický kraj";1;0;0;0;NA;136515;1;2020-08-20;211
2020-08-19;"Banskobystrický kraj";4;0;0;0;NA;136515;4;2020-08-19;210
2020-08-18;"Banskobystrický kraj";0;0;0;0;NA;136515;0;2020-08-18;206
2020-08-17;"Banskobystrický kraj";1;0;0;0;NA;136515;1;2020-08-17;206
2020-08-16;"Banskobystrický kraj";0;0;0;0;NA;136515;0;2020-08-16;205
2020-08-15;"Banskobystrický kraj";0;0;0;0;NA;136515;0;2020-08-15;205
2020-08-14;"Banskobystrický kraj";5;0;0;0;NA;136515;5;2020-08-14;205
2020-08-13;"Banskobystrický kraj";0;0;0;0;NA;136515;0;2020-08-13;200
2020-08-12;"Banskobystrický kraj";0;0;0;0;NA;136515;0;2020-08-12;200
2020-08-11;"Banskobystrický kraj";2;0;0;0;NA;136515;2;2020-08-11;200
2020-08-10;"Banskobystrický kraj";3;0;0;0;NA;136515;3;2020-08-10;198
2020-08-09;"Banskobystrický kraj";0;0;0;0;NA;136515;0;2020-08-09;195
2020-08-08;"Banskobystrický kraj";2;0;0;0;NA;136515;2;2020-08-08;195
2020-08-07;"Banskobystrický kraj";1;0;0;0;NA;136515;1;2020-08-07;193
2020-08-06;"Banskobystrický kraj";1;0;0;0;NA;136515;1;2020-08-06;192
2020-08-05;"Banskobystrický kraj";0;0;0;0;NA;136515;0;2020-08-05;191
2020-08-04;"Banskobystrický kraj";3;0;0;0;NA;136515;3;2020-08-04;191
2020-08-03;"Banskobystrický kraj";0;0;0;0;NA;136515;0;2020-08-03;188
2020-08-02;"Banskobystrický kraj";0;0;0;0;NA;136515;0;2020-08-02;188
2020-08-01;"Banskobystrický kraj";1;0;0;0;NA;136515;1;2020-08-01;188
2020-07-31;"Banskobystrický kraj";2;0;0;0;NA;136515;2;2020-07-31;187
2020-07-30;"Banskobystrický kraj";1;0;0;0;NA;136515;1;2020-07-30;185
2020-07-29;"Banskobystrický kraj";0;0;0;0;NA;136515;0;2020-07-29;184
2020-07-28;"Banskobystrický kraj";2;0;0;0;NA;136515;2;2020-07-28;184
2020-07-27;"Banskobystrický kraj";3;0;0;0;NA;136515;3;2020-07-27;182
2020-07-26;"Banskobystrický kraj";0;0;0;0;NA;136515;0;2020-07-26;179
2020-07-25;"Banskobystrický kraj";0;0;0;0;NA;136515;0;2020-07-25;179
2020-07-24;"Banskobystrický kraj";9;0;0;0;NA;136515;9;2020-07-24;179
2020-07-23;"Banskobystrický kraj";0;0;0;0;NA;136515;0;2020-07-23;170
2020-07-22;"Banskobystrický kraj";3;0;0;0;NA;136515;3;2020-07-22;170
2020-07-21;"Banskobystrický kraj";3;0;0;0;NA;136515;3;2020-07-21;167
2020-07-20;"Banskobystrický kraj";1;0;0;0;NA;136515;1;2020-07-20;164
2020-07-19;"Banskobystrický kraj";1;0;0;0;NA;136515;1;2020-07-19;163
2020-07-18;"Banskobystrický kraj";0;0;0;0;NA;136515;0;2020-07-18;162
2020-07-17;"Banskobystrický kraj";2;0;0;0;NA;136515;2;2020-07-17;162
2020-07-16;"Banskobystrický kraj";1;0;0;0;NA;136515;1;2020-07-16;160
2020-07-15;"Banskobystrický kraj";4;0;0;0;NA;136515;4;2020-07-15;159
2020-07-14;"Banskobystrický kraj";2;0;0;0;NA;136515;2;2020-07-14;155
2020-07-13;"Banskobystrický kraj";1;0;0;0;NA;136515;1;2020-07-13;153
2020-07-12;"Banskobystrický kraj";0;0;0;0;NA;136515;0;2020-07-12;152
2020-07-11;"Banskobystrický kraj";0;0;0;0;NA;136515;0;2020-07-11;152
2020-07-10;"Banskobystrický kraj";3;0;0;0;NA;136515;3;2020-07-10;152
2020-07-09;"Banskobystrický kraj";9;0;0;0;NA;136515;9;2020-07-09;149
2020-07-08;"Banskobystrický kraj";0;0;0;0;NA;136515;0;2020-07-08;140
2020-07-07;"Banskobystrický kraj";4;0;0;0;NA;136515;4;2020-07-07;140
2020-07-06;"Banskobystrický kraj";0;0;0;0;NA;136515;0;2020-07-06;136
2020-07-05;"Banskobystrický kraj";0;0;0;0;NA;136515;0;2020-07-05;136
2020-07-04;"Banskobystrický kraj";1;0;0;0;NA;136515;1;2020-07-04;136
2020-07-03;"Banskobystrický kraj";4;0;0;0;NA;136515;4;2020-07-03;135
2020-07-02;"Banskobystrický kraj";0;0;0;0;NA;136515;0;2020-07-02;131
2020-07-01;"Banskobystrický kraj";1;0;0;0;NA;136515;1;2020-07-01;131
2020-06-30;"Banskobystrický kraj";0;12;0;12;NA;136515;0;2020-06-30;130
2020-06-29;"Banskobystrický kraj";0;0;0;0;NA;136515;0;2020-06-29;130
2020-06-28;"Banskobystrický kraj";0;0;0;0;NA;136515;0;2020-06-28;130
2020-06-27;"Banskobystrický kraj";0;0;0;0;NA;136515;0;2020-06-27;130
2020-06-26;"Banskobystrický kraj";0;0;0;0;NA;136515;0;2020-06-26;130
2020-06-25;"Banskobystrický kraj";1;0;0;0;NA;136515;1;2020-06-25;130
2020-06-24;"Banskobystrický kraj";0;0;0;0;NA;136515;0;2020-06-24;129
2020-06-23;"Banskobystrický kraj";6;0;0;0;NA;136515;6;2020-06-23;129
2020-06-22;"Banskobystrický kraj";0;0;0;0;NA;136515;0;2020-06-22;123
2020-06-21;"Banskobystrický kraj";0;0;0;0;NA;136515;0;2020-06-21;123
2020-06-20;"Banskobystrický kraj";0;0;0;0;NA;136515;0;2020-06-20;123
2020-06-19;"Banskobystrický kraj";2;0;0;0;NA;136515;2;2020-06-19;123
2020-06-18;"Banskobystrický kraj";10;0;0;0;NA;136515;10;2020-06-18;121
2020-06-17;"Banskobystrický kraj";1;0;0;0;NA;136515;1;2020-06-17;111
2020-06-16;"Banskobystrický kraj";0;0;0;0;NA;136515;0;2020-06-16;110
2020-06-14;"Banskobystrický kraj";2;0;0;0;NA;136515;2;2020-06-14;110
2020-06-13;"Banskobystrický kraj";2;0;0;0;NA;136515;2;2020-06-13;108
2020-06-12;"Banskobystrický kraj";0;0;0;0;NA;136515;0;2020-06-12;106
2020-06-11;"Banskobystrický kraj";1;0;0;0;NA;136515;1;2020-06-11;106
2020-06-10;"Banskobystrický kraj";0;0;0;0;NA;136515;0;2020-06-10;105
2020-06-09;"Banskobystrický kraj";0;0;0;0;NA;136515;0;2020-06-09;105
2020-06-08;"Banskobystrický kraj";0;0;0;0;NA;136515;0;2020-06-08;105
2020-06-07;"Banskobystrický kraj";0;0;0;0;NA;136515;0;2020-06-07;105
2020-06-05;"Banskobystrický kraj";2;0;0;0;NA;136515;2;2020-06-05;105
2020-06-03;"Banskobystrický kraj";0;0;0;0;NA;136515;0;2020-06-03;103
2020-06-02;"Banskobystrický kraj";0;0;0;0;NA;136515;0;2020-06-02;103
2020-05-31;"Banskobystrický kraj";0;0;0;0;NA;136515;0;2020-05-31;103
2020-05-29;"Banskobystrický kraj";0;0;0;0;NA;136515;0;2020-05-29;103
2020-05-27;"Banskobystrický kraj";1;0;0;0;NA;136515;1;2020-05-27;103
2020-05-26;"Banskobystrický kraj";0;0;0;0;NA;136515;0;2020-05-26;102
2020-05-25;"Banskobystrický kraj";0;0;0;0;NA;136515;0;2020-05-25;102
2020-05-24;"Banskobystrický kraj";0;0;0;0;NA;136515;0;2020-05-24;102
2020-05-23;"Banskobystrický kraj";1;0;0;0;NA;136515;1;2020-05-23;102
2020-05-22;"Banskobystrický kraj";0;0;0;0;NA;136515;0;2020-05-22;101
2020-05-21;"Banskobystrický kraj";0;0;0;0;NA;136515;0;2020-05-21;101
2020-05-20;"Banskobystrický kraj";1;0;0;0;NA;136515;1;2020-05-20;101
2020-05-19;"Banskobystrický kraj";0;0;0;0;NA;136515;0;2020-05-19;100
2020-05-17;"Banskobystrický kraj";0;0;0;0;NA;136515;0;2020-05-17;100
2020-05-16;"Banskobystrický kraj";0;0;0;0;NA;136515;0;2020-05-16;100
2020-05-15;"Banskobystrický kraj";0;0;0;0;NA;136515;0;2020-05-15;100
2020-05-14;"Banskobystrický kraj";0;0;0;0;NA;136515;0;2020-05-14;100
2020-05-13;"Banskobystrický kraj";0;0;0;0;NA;136515;0;2020-05-13;100
2020-05-12;"Banskobystrický kraj";1;0;0;0;NA;136515;1;2020-05-12;100
2020-05-11;"Banskobystrický kraj";0;0;0;0;NA;136515;0;2020-05-11;99
2020-05-09;"Banskobystrický kraj";0;0;0;0;NA;136515;0;2020-05-09;99
2020-05-07;"Banskobystrický kraj";2;0;0;0;NA;136515;2;2020-05-07;99
2020-05-06;"Banskobystrický kraj";1;0;0;0;NA;136515;1;2020-05-06;97
2020-05-05;"Banskobystrický kraj";2;0;0;0;NA;136515;2;2020-05-05;96
2020-05-04;"Banskobystrický kraj";0;0;0;0;NA;136515;0;2020-05-04;94
2020-05-03;"Banskobystrický kraj";0;0;0;0;NA;136515;0;2020-05-03;94
2020-05-02;"Banskobystrický kraj";0;0;0;0;NA;136515;0;2020-05-02;94
2020-05-01;"Banskobystrický kraj";0;0;0;0;NA;136515;0;2020-05-01;94
2020-04-30;"Banskobystrický kraj";1;0;0;0;NA;136515;1;2020-04-30;94
2020-04-29;"Banskobystrický kraj";1;0;0;0;NA;136515;1;2020-04-29;93
2020-04-28;"Banskobystrický kraj";0;0;0;0;NA;136515;0;2020-04-28;92
2020-04-27;"Banskobystrický kraj";0;0;0;0;NA;136515;0;2020-04-27;92
2020-04-26;"Banskobystrický kraj";0;0;0;0;NA;136515;0;2020-04-26;92
2020-04-25;"Banskobystrický kraj";2;0;0;0;NA;136515;2;2020-04-25;92
2020-04-24;"Banskobystrický kraj";3;0;0;0;NA;136515;3;2020-04-24;90
2020-04-23;"Banskobystrický kraj";2;0;0;0;NA;136515;2;2020-04-23;87
2020-04-22;"Banskobystrický kraj";2;0;0;0;NA;136515;2;2020-04-22;85
2020-04-21;"Banskobystrický kraj";2;0;0;0;NA;136515;2;2020-04-21;83
2020-04-20;"Banskobystrický kraj";0;0;0;0;NA;136515;0;2020-04-20;81
2020-04-19;"Banskobystrický kraj";0;0;0;0;NA;136515;0;2020-04-19;81
2020-04-18;"Banskobystrický kraj";8;0;0;0;NA;136515;8;2020-04-18;81
2020-04-17;"Banskobystrický kraj";2;0;0;0;NA;136515;2;2020-04-17;73
2020-04-16;"Banskobystrický kraj";0;0;0;0;NA;136515;0;2020-04-16;71
2020-04-15;"Banskobystrický kraj";10;0;0;0;NA;136515;10;2020-04-15;71
2020-04-14;"Banskobystrický kraj";0;0;0;0;NA;136515;0;2020-04-14;61
2020-04-13;"Banskobystrický kraj";2;0;0;0;NA;136515;2;2020-04-13;61
2020-04-12;"Banskobystrický kraj";4;0;0;0;NA;136515;4;2020-04-12;59
2020-04-11;"Banskobystrický kraj";1;0;0;0;NA;136515;1;2020-04-11;55
2020-04-10;"Banskobystrický kraj";0;0;0;0;NA;136515;0;2020-04-10;54
2020-04-09;"Banskobystrický kraj";2;0;0;0;NA;136515;2;2020-04-09;54
2020-04-08;"Banskobystrický kraj";0;0;0;0;NA;136515;0;2020-04-08;52
2020-04-07;"Banskobystrický kraj";4;0;0;0;NA;136515;4;2020-04-07;52
2020-04-06;"Banskobystrický kraj";10;0;0;0;NA;136515;10;2020-04-06;48
2020-04-05;"Banskobystrický kraj";9;0;0;0;NA;136515;9;2020-04-05;38
2020-04-04;"Banskobystrický kraj";0;0;0;0;NA;136515;0;2020-04-04;29
2020-04-03;"Banskobystrický kraj";2;0;0;0;NA;136515;2;2020-04-03;29
2020-04-02;"Banskobystrický kraj";2;0;0;0;NA;136515;2;2020-04-02;27
2020-04-01;"Banskobystrický kraj";5;0;0;0;NA;136515;5;2020-04-01;25
2020-03-31;"Banskobystrický kraj";3;0;0;0;NA;136515;3;2020-03-31;20
2020-03-30;"Banskobystrický kraj";1;0;0;0;NA;136515;1;2020-03-30;17
2020-03-29;"Banskobystrický kraj";2;0;0;0;NA;136515;2;2020-03-29;16
2020-03-28;"Banskobystrický kraj";1;0;0;0;NA;136515;1;2020-03-28;14
2020-03-27;"Banskobystrický kraj";1;0;0;0;NA;136515;1;2020-03-27;13
2020-03-26;"Banskobystrický kraj";1;0;0;0;NA;136515;1;2020-03-26;12
2020-03-25;"Banskobystrický kraj";0;0;0;0;NA;136515;0;2020-03-25;11
2020-03-24;"Banskobystrický kraj";1;0;0;0;NA;136515;1;2020-03-24;11
2020-03-23;"Banskobystrický kraj";1;0;0;0;NA;136515;1;2020-03-23;10
2020-03-22;"Banskobystrický kraj";0;0;0;0;NA;136515;0;2020-03-22;9
2020-03-21;"Banskobystrický kraj";3;0;0;0;NA;136515;3;2020-03-21;9
2020-03-20;"Banskobystrický kraj";0;0;0;0;NA;136515;0;2020-03-20;6
2020-03-19;"Banskobystrický kraj";2;0;0;0;NA;136515;2;2020-03-19;6
2020-03-18;"Banskobystrický kraj";1;0;0;0;NA;136515;1;2020-03-18;4
2020-03-17;"Banskobystrický kraj";1;0;0;0;NA;136515;1;2020-03-17;3
2020-03-16;"Banskobystrický kraj";0;0;0;0;NA;136515;0;2020-03-16;2
2020-03-15;"Banskobystrický kraj";1;0;0;0;NA;136515;1;2020-03-15;2
2020-03-14;"Banskobystrický kraj";0;0;0;0;NA;136515;0;2020-03-14;1
2020-03-13;"Banskobystrický kraj";1;0;0;0;NA;136515;1;2020-03-13;1
2020-03-12;"Banskobystrický kraj";0;0;0;0;NA;136515;0;2020-03-12;0
2020-03-11;"Banskobystrický kraj";0;0;0;0;NA;136515;0;2020-03-11;0
2020-03-09;"Banskobystrický kraj";0;0;0;0;NA;136515;0;2020-03-09;0
2020-03-08;"Banskobystrický kraj";0;0;0;0;NA;136515;0;2020-03-08;0
2020-03-07;"Banskobystrický kraj";0;0;0;0;NA;136515;0;2020-03-07;0
2020-03-06;"Banskobystrický kraj";0;0;0;0;NA;136515;0;2020-03-06;0
2021-12-02;"Bratislavský kraj";2053;118;1;119;83828;145281;2054;2021-12-02;145281
2021-12-01;"Bratislavský kraj";1161;7488;174;7662;NA;145281;1335;2021-12-01;143227
2021-11-30;"Bratislavský kraj";1442;5551;269;5820;NA;145281;1711;2021-11-30;141892
2021-11-29;"Bratislavský kraj";863;7951;362;8313;NA;145281;1225;2021-11-29;140181
2021-11-28;"Bratislavský kraj";617;5102;295;5397;NA;145281;912;2021-11-28;138956
2021-11-27;"Bratislavský kraj";1026;3495;329;3824;NA;145281;1355;2021-11-27;138044
2021-11-26;"Bratislavský kraj";1346;5458;421;5879;NA;145281;1767;2021-11-26;136689
2021-11-25;"Bratislavský kraj";1415;6333;448;6781;NA;145281;1863;2021-11-25;134922
2021-11-24;"Bratislavský kraj";1286;6818;467;7285;NA;145281;1753;2021-11-24;133059
2021-11-23;"Bratislavský kraj";1651;6278;428;6706;NA;145281;2079;2021-11-23;131306
2021-11-22;"Bratislavský kraj";1197;8716;584;9300;NA;145281;1781;2021-11-22;129227
2021-11-21;"Bratislavský kraj";702;4324;320;4644;NA;145281;1022;2021-11-21;127446
2021-11-20;"Bratislavský kraj";1005;3514;360;3874;NA;145281;1365;2021-11-20;126424
2021-11-19;"Bratislavský kraj";1444;5927;549;6476;NA;145281;1993;2021-11-19;125059
2021-11-18;"Bratislavský kraj";1052;6358;548;6906;NA;145281;1600;2021-11-18;123066
2021-11-17;"Bratislavský kraj";832;2439;308;2747;NA;145281;1140;2021-11-17;121466
2021-11-16;"Bratislavský kraj";1067;5792;443;6235;NA;145281;1510;2021-11-16;120326
2021-11-15;"Bratislavský kraj";1014;6330;519;6849;NA;145281;1533;2021-11-15;118816
2021-11-14;"Bratislavský kraj";448;3202;335;3537;NA;145281;783;2021-11-14;117283
2021-11-13;"Bratislavský kraj";587;3251;313;3564;NA;145281;900;2021-11-13;116500
2021-11-12;"Bratislavský kraj";856;5723;357;6080;NA;145281;1213;2021-11-12;115600
2021-11-11;"Bratislavský kraj";787;6028;355;6383;NA;145281;1142;2021-11-11;114387
2021-11-10;"Bratislavský kraj";840;5903;385;6288;NA;145281;1225;2021-11-10;113245
2021-11-09;"Bratislavský kraj";939;5733;350;6083;NA;145281;1289;2021-11-09;112020
2021-11-08;"Bratislavský kraj";579;5641;404;6045;NA;145281;983;2021-11-08;110731
2021-11-07;"Bratislavský kraj";363;2836;244;3080;NA;145281;607;2021-11-07;109748
2021-11-06;"Bratislavský kraj";538;2901;243;3144;NA;145281;781;2021-11-06;109141
2021-11-05;"Bratislavský kraj";801;5640;318;5958;NA;145281;1119;2021-11-05;108360
2021-11-04;"Bratislavský kraj";768;5233;273;5506;NA;145281;1041;2021-11-04;107241
2021-11-03;"Bratislavský kraj";690;5120;290;5410;NA;145281;980;2021-11-03;106200
2021-11-02;"Bratislavský kraj";422;6356;327;6683;NA;145281;749;2021-11-02;105220
2021-11-01;"Bratislavský kraj";395;1726;136;1862;NA;145281;531;2021-11-01;104471
2021-10-31;"Bratislavský kraj";209;2280;163;2443;NA;145281;372;2021-10-31;103940
2021-10-30;"Bratislavský kraj";429;2138;118;2256;NA;145281;547;2021-10-30;103568
2021-10-29;"Bratislavský kraj";445;4757;219;4976;NA;145281;664;2021-10-29;103021
2021-10-28;"Bratislavský kraj";372;4777;179;4956;NA;145281;551;2021-10-28;102357
2021-10-27;"Bratislavský kraj";376;4522;164;4686;NA;145281;540;2021-10-27;101806
2021-10-26;"Bratislavský kraj";461;4492;188;4680;NA;145281;649;2021-10-26;101266
2021-10-25;"Bratislavský kraj";379;5347;192;5539;NA;145281;571;2021-10-25;100617
2021-10-24;"Bratislavský kraj";114;2369;91;2460;NA;145281;205;2021-10-24;100046
2021-10-23;"Bratislavský kraj";301;2666;91;2757;NA;145281;392;2021-10-23;99841
2021-10-22;"Bratislavský kraj";309;4455;122;4577;NA;145281;431;2021-10-22;99449
2021-10-21;"Bratislavský kraj";244;4544;101;4645;NA;145281;345;2021-10-21;99018
2021-10-20;"Bratislavský kraj";262;3897;95;3992;NA;145281;357;2021-10-20;98673
2021-10-19;"Bratislavský kraj";260;4116;68;4184;NA;145281;328;2021-10-19;98316
2021-10-18;"Bratislavský kraj";250;5014;114;5128;NA;145281;364;2021-10-18;97988
2021-10-17;"Bratislavský kraj";54;2460;73;2533;NA;145281;127;2021-10-17;97624
2021-10-16;"Bratislavský kraj";185;2687;63;2750;NA;145281;248;2021-10-16;97497
2021-10-15;"Bratislavský kraj";169;4200;64;4264;NA;145281;233;2021-10-15;97249
2021-10-14;"Bratislavský kraj";173;4714;61;4775;NA;145281;234;2021-10-14;97016
2021-10-13;"Bratislavský kraj";143;3671;76;3747;NA;145281;219;2021-10-13;96782
2021-10-12;"Bratislavský kraj";183;4037;78;4115;NA;145281;261;2021-10-12;96563
2021-10-11;"Bratislavský kraj";191;4798;88;4886;NA;145281;279;2021-10-11;96302
2021-10-10;"Bratislavský kraj";29;2176;43;2219;NA;145281;72;2021-10-10;96023
2021-10-09;"Bratislavský kraj";141;2419;34;2453;NA;145281;175;2021-10-09;95951
2021-10-08;"Bratislavský kraj";130;4511;63;4574;NA;145281;193;2021-10-08;95776
2021-10-07;"Bratislavský kraj";92;4137;61;4198;NA;145281;153;2021-10-07;95583
2021-10-06;"Bratislavský kraj";147;4026;68;4094;NA;145281;215;2021-10-06;95430
2021-10-05;"Bratislavský kraj";164;4468;70;4538;NA;145281;234;2021-10-05;95215
2021-10-04;"Bratislavský kraj";129;4653;79;4732;NA;145281;208;2021-10-04;94981
2021-10-03;"Bratislavský kraj";41;2144;42;2186;NA;145281;83;2021-10-03;94773
2021-10-02;"Bratislavský kraj";104;2605;40;2645;NA;145281;144;2021-10-02;94690
2021-10-01;"Bratislavský kraj";108;4809;57;4866;NA;145281;165;2021-10-01;94546
2021-09-30;"Bratislavský kraj";90;3800;60;3860;NA;145281;150;2021-09-30;94381
2021-09-29;"Bratislavský kraj";115;3508;58;3566;NA;145281;173;2021-09-29;94231
2021-09-28;"Bratislavský kraj";144;4003;48;4051;NA;145281;192;2021-09-28;94058
2021-09-27;"Bratislavský kraj";123;4427;70;4497;NA;145281;193;2021-09-27;93866
2021-09-26;"Bratislavský kraj";32;2194;31;2225;NA;145281;63;2021-09-26;93673
2021-09-25;"Bratislavský kraj";85;2742;38;2780;NA;145281;123;2021-09-25;93610
2021-09-24;"Bratislavský kraj";82;4207;59;4266;NA;145281;141;2021-09-24;93487
2021-09-23;"Bratislavský kraj";90;3975;51;4026;NA;145281;141;2021-09-23;93346
2021-09-22;"Bratislavský kraj";84;3757;63;3820;NA;145281;147;2021-09-22;93205
2021-09-21;"Bratislavský kraj";95;3574;39;3613;NA;145281;134;2021-09-21;93058
2021-09-20;"Bratislavský kraj";84;3937;31;3968;NA;145281;115;2021-09-20;92924
2021-09-19;"Bratislavský kraj";31;1850;28;1878;NA;145281;59;2021-09-19;92809
2021-09-18;"Bratislavský kraj";60;1989;19;2008;NA;145281;79;2021-09-18;92750
2021-09-17;"Bratislavský kraj";87;3443;27;3470;NA;145281;114;2021-09-17;92671
2021-09-16;"Bratislavský kraj";57;3772;43;3815;NA;145281;100;2021-09-16;92557
2021-09-15;"Bratislavský kraj";41;1104;21;1125;NA;145281;62;2021-09-15;92457
2021-09-14;"Bratislavský kraj";78;3518;31;3549;NA;145281;109;2021-09-14;92395
2021-09-13;"Bratislavský kraj";47;3156;28;3184;NA;145281;75;2021-09-13;92286
2021-09-12;"Bratislavský kraj";13;1713;21;1734;NA;145281;34;2021-09-12;92211
2021-09-11;"Bratislavský kraj";36;2064;13;2077;NA;145281;49;2021-09-11;92177
2021-09-10;"Bratislavský kraj";47;3628;18;3646;NA;145281;65;2021-09-10;92128
2021-09-09;"Bratislavský kraj";50;3010;30;3040;NA;145281;80;2021-09-09;92063
2021-09-08;"Bratislavský kraj";56;2925;20;2945;NA;145281;76;2021-09-08;91983
2021-09-07;"Bratislavský kraj";50;3272;18;3290;NA;145281;68;2021-09-07;91907
2021-09-06;"Bratislavský kraj";63;2791;29;2820;NA;145281;92;2021-09-06;91839
2021-09-05;"Bratislavský kraj";10;1682;14;1696;NA;145281;24;2021-09-05;91747
2021-09-04;"Bratislavský kraj";41;2612;11;2623;NA;145281;52;2021-09-04;91723
2021-09-03;"Bratislavský kraj";55;3016;14;3030;NA;145281;69;2021-09-03;91671
2021-09-02;"Bratislavský kraj";35;2423;23;2446;NA;145281;58;2021-09-02;91602
2021-09-01;"Bratislavský kraj";16;929;9;938;NA;145281;25;2021-09-01;91544
2021-08-31;"Bratislavský kraj";28;5197;22;5219;NA;145281;50;2021-08-31;91519
2021-08-30;"Bratislavský kraj";24;2403;13;2416;NA;145281;37;2021-08-30;91469
2021-08-29;"Bratislavský kraj";11;1016;6;1022;NA;145281;17;2021-08-29;91432
2021-08-28;"Bratislavský kraj";24;1714;11;1725;NA;145281;35;2021-08-28;91415
2021-08-27;"Bratislavský kraj";19;2850;9;2859;NA;145281;28;2021-08-27;91380
2021-08-26;"Bratislavský kraj";15;2382;19;2401;NA;145281;34;2021-08-26;91352
2021-08-25;"Bratislavský kraj";29;1888;10;1898;NA;145281;39;2021-08-25;91318
2021-08-24;"Bratislavský kraj";22;1785;4;1789;NA;145281;26;2021-08-24;91279
2021-08-23;"Bratislavský kraj";21;2183;7;2190;NA;145281;28;2021-08-23;91253
2021-08-22;"Bratislavský kraj";5;1383;8;1391;NA;145281;13;2021-08-22;91225
2021-08-21;"Bratislavský kraj";18;1681;4;1685;NA;145281;22;2021-08-21;91212
2021-08-20;"Bratislavský kraj";27;2743;19;2762;NA;145281;46;2021-08-20;91190
2021-08-19;"Bratislavský kraj";15;2122;9;2131;NA;145281;24;2021-08-19;91144
2021-08-18;"Bratislavský kraj";16;1659;11;1670;NA;145281;27;2021-08-18;91120
2021-08-17;"Bratislavský kraj";18;1600;5;1605;NA;145281;23;2021-08-17;91093
2021-08-16;"Bratislavský kraj";18;2559;12;2571;NA;145281;30;2021-08-16;91070
2021-08-15;"Bratislavský kraj";3;1169;6;1175;NA;145281;9;2021-08-15;91040
2021-08-14;"Bratislavský kraj";11;1519;4;1523;NA;145281;15;2021-08-14;91031
2021-08-13;"Bratislavský kraj";32;2628;7;2635;NA;145281;39;2021-08-13;91016
2021-08-12;"Bratislavský kraj";16;1824;9;1833;NA;145281;25;2021-08-12;90977
2021-08-11;"Bratislavský kraj";22;1621;5;1626;NA;145281;27;2021-08-11;90952
2021-08-10;"Bratislavský kraj";15;1624;7;1631;NA;145281;22;2021-08-10;90925
2021-08-09;"Bratislavský kraj";35;1917;9;1926;NA;145281;44;2021-08-09;90903
2021-08-08;"Bratislavský kraj";3;1152;4;1156;NA;145281;7;2021-08-08;90859
2021-08-07;"Bratislavský kraj";6;1572;9;1581;NA;145281;15;2021-08-07;90852
2021-08-06;"Bratislavský kraj";9;2510;10;2520;NA;145281;19;2021-08-06;90837
2021-08-05;"Bratislavský kraj";10;1651;7;1658;NA;145281;17;2021-08-05;90818
2021-08-04;"Bratislavský kraj";9;1578;0;1578;NA;145281;9;2021-08-04;90801
2021-08-03;"Bratislavský kraj";11;1507;5;1512;NA;145281;16;2021-08-03;90792
2021-08-02;"Bratislavský kraj";15;1749;11;1760;NA;145281;26;2021-08-02;90776
2021-08-01;"Bratislavský kraj";4;1224;8;1232;NA;145281;12;2021-08-01;90750
2021-07-31;"Bratislavský kraj";7;1623;2;1625;NA;145281;9;2021-07-31;90738
2021-07-30;"Bratislavský kraj";15;2540;7;2547;NA;145281;22;2021-07-30;90729
2021-07-29;"Bratislavský kraj";19;1790;7;1797;NA;145281;26;2021-07-29;90707
2021-07-28;"Bratislavský kraj";8;1538;11;1549;NA;145281;19;2021-07-28;90681
2021-07-27;"Bratislavský kraj";9;1476;5;1481;NA;145281;14;2021-07-27;90662
2021-07-26;"Bratislavský kraj";17;1806;7;1813;NA;145281;24;2021-07-26;90648
2021-07-25;"Bratislavský kraj";4;1411;2;1413;NA;145281;6;2021-07-25;90624
2021-07-24;"Bratislavský kraj";9;1732;3;1735;NA;145281;12;2021-07-24;90618
2021-07-23;"Bratislavský kraj";6;2400;3;2403;NA;145281;9;2021-07-23;90606
2021-07-22;"Bratislavský kraj";12;1944;6;1950;NA;145281;18;2021-07-22;90597
2021-07-21;"Bratislavský kraj";5;1860;6;1866;NA;145281;11;2021-07-21;90579
2021-07-20;"Bratislavský kraj";19;1550;1;1551;NA;145281;20;2021-07-20;90568
2021-07-19;"Bratislavský kraj";15;2259;3;2262;NA;145281;18;2021-07-19;90548
2021-07-18;"Bratislavský kraj";2;1462;3;1465;NA;145281;5;2021-07-18;90530
2021-07-17;"Bratislavský kraj";3;1870;2;1872;NA;145281;5;2021-07-17;90525
2021-07-16;"Bratislavský kraj";8;2834;4;2838;NA;145281;12;2021-07-16;90520
2021-07-15;"Bratislavský kraj";5;1677;0;1677;NA;145281;5;2021-07-15;90508
2021-07-14;"Bratislavský kraj";5;1895;3;1898;NA;145281;8;2021-07-14;90503
2021-07-13;"Bratislavský kraj";4;1584;4;1588;NA;145281;8;2021-07-13;90495
2021-07-12;"Bratislavský kraj";6;1780;5;1785;NA;145281;11;2021-07-12;90487
2021-07-11;"Bratislavský kraj";3;1896;3;1899;NA;145281;6;2021-07-11;90476
2021-07-10;"Bratislavský kraj";5;2240;3;2243;NA;145281;8;2021-07-10;90470
2021-07-09;"Bratislavský kraj";13;3538;7;3545;NA;145281;20;2021-07-09;90462
2021-07-08;"Bratislavský kraj";9;2433;4;2437;NA;145281;13;2021-07-08;90442
2021-07-07;"Bratislavský kraj";5;2792;4;2796;NA;145281;9;2021-07-07;90429
2021-07-06;"Bratislavský kraj";19;2771;4;2775;NA;145281;23;2021-07-06;90420
2021-07-05;"Bratislavský kraj";5;2455;5;2460;NA;145281;10;2021-07-05;90397
2021-07-04;"Bratislavský kraj";3;1824;2;1826;NA;145281;5;2021-07-04;90387
2021-07-03;"Bratislavský kraj";8;2205;5;2210;NA;145281;13;2021-07-03;90382
2021-07-02;"Bratislavský kraj";4;2227;4;2231;NA;145281;8;2021-07-02;90369
2021-07-01;"Bratislavský kraj";6;1809;5;1814;NA;145281;11;2021-07-01;90361
2021-06-30;"Bratislavský kraj";2;11548;11;11559;NA;145281;13;2021-06-30;90350
2021-06-29;"Bratislavský kraj";5;6831;7;6838;NA;145281;12;2021-06-29;90337
2021-06-28;"Bratislavský kraj";16;6651;24;6675;NA;145281;40;2021-06-28;90325
2021-06-27;"Bratislavský kraj";4;6689;11;6700;NA;145281;15;2021-06-27;90285
2021-06-26;"Bratislavský kraj";3;8741;6;8747;NA;145281;9;2021-06-26;90270
2021-06-25;"Bratislavský kraj";7;10285;15;10300;NA;145281;22;2021-06-25;90261
2021-06-24;"Bratislavský kraj";3;7384;16;7400;NA;145281;19;2021-06-24;90239
2021-06-23;"Bratislavský kraj";4;7346;12;7358;NA;145281;16;2021-06-23;90220
2021-06-22;"Bratislavský kraj";6;7244;10;7254;NA;145281;16;2021-06-22;90204
2021-06-21;"Bratislavský kraj";5;7641;9;7650;NA;145281;14;2021-06-21;90188
2021-06-20;"Bratislavský kraj";0;7369;5;7374;NA;145281;5;2021-06-20;90174
2021-06-19;"Bratislavský kraj";3;9226;4;9230;NA;145281;7;2021-06-19;90169
2021-06-18;"Bratislavský kraj";5;12763;9;12772;NA;145281;14;2021-06-18;90162
2021-06-17;"Bratislavský kraj";3;8625;13;8638;NA;145281;16;2021-06-17;90148
2021-06-16;"Bratislavský kraj";3;7105;4;7109;NA;145281;7;2021-06-16;90132
2021-06-15;"Bratislavský kraj";7;7309;17;7326;NA;145281;24;2021-06-15;90125
2021-06-14;"Bratislavský kraj";4;8231;9;8240;NA;145281;13;2021-06-14;90101
2021-06-13;"Bratislavský kraj";2;8791;11;8802;NA;145281;13;2021-06-13;90088
2021-06-12;"Bratislavský kraj";4;11152;11;11163;NA;145281;15;2021-06-12;90075
2021-06-11;"Bratislavský kraj";9;13644;21;13665;NA;145281;30;2021-06-11;90060
2021-06-10;"Bratislavský kraj";12;8637;15;8652;NA;145281;27;2021-06-10;90030
2021-06-09;"Bratislavský kraj";12;7596;12;7608;NA;145281;24;2021-06-09;90003
2021-06-08;"Bratislavský kraj";13;7907;29;7936;NA;145281;42;2021-06-08;89979
2021-06-07;"Bratislavský kraj";13;9247;43;9290;NA;145281;56;2021-06-07;89937
2021-06-06;"Bratislavský kraj";3;10350;20;10370;NA;145281;23;2021-06-06;89881
2021-06-05;"Bratislavský kraj";2;12692;15;12707;NA;145281;17;2021-06-05;89858
2021-06-04;"Bratislavský kraj";10;13846;31;13877;NA;145281;41;2021-06-04;89841
2021-06-03;"Bratislavský kraj";12;9615;19;9634;NA;145281;31;2021-06-03;89800
2021-06-02;"Bratislavský kraj";10;8684;17;8701;NA;145281;27;2021-06-02;89769
2021-06-01;"Bratislavský kraj";3;8812;25;8837;NA;145281;28;2021-06-01;89742
2021-05-31;"Bratislavský kraj";18;11248;32;11280;NA;145281;50;2021-05-31;89714
2021-05-30;"Bratislavský kraj";1;11758;17;11775;NA;145281;18;2021-05-30;89664
2021-05-29;"Bratislavský kraj";4;12245;8;12253;NA;145281;12;2021-05-29;89646
2021-05-28;"Bratislavský kraj";14;15865;23;15888;NA;145281;37;2021-05-28;89634
2021-05-27;"Bratislavský kraj";5;11321;18;11339;NA;145281;23;2021-05-27;89597
2021-05-26;"Bratislavský kraj";20;10709;17;10726;NA;145281;37;2021-05-26;89574
2021-05-25;"Bratislavský kraj";19;11864;31;11895;NA;145281;50;2021-05-25;89537
2021-05-24;"Bratislavský kraj";12;12966;23;12989;NA;145281;35;2021-05-24;89487
2021-05-23;"Bratislavský kraj";7;13074;24;13098;NA;145281;31;2021-05-23;89452
2021-05-22;"Bratislavský kraj";6;14044;22;14066;NA;145281;28;2021-05-22;89421
2021-05-21;"Bratislavský kraj";15;18996;22;19018;NA;145281;37;2021-05-21;89393
2021-05-20;"Bratislavský kraj";15;14112;17;14129;NA;145281;32;2021-05-20;89356
2021-05-19;"Bratislavský kraj";21;11958;24;11982;NA;145281;45;2021-05-19;89324
2021-05-18;"Bratislavský kraj";14;13005;33;13038;NA;145281;47;2021-05-18;89279
2021-05-17;"Bratislavský kraj";15;13854;29;13883;NA;145281;44;2021-05-17;89232
2021-05-16;"Bratislavský kraj";12;19797;32;19829;NA;145281;44;2021-05-16;89188
2021-05-15;"Bratislavský kraj";1;18113;30;18143;NA;145281;31;2021-05-15;89144
2021-05-14;"Bratislavský kraj";15;22228;30;22258;NA;145281;45;2021-05-14;89113
2021-05-13;"Bratislavský kraj";9;16211;17;16228;NA;145281;26;2021-05-13;89068
2021-05-12;"Bratislavský kraj";11;14638;28;14666;NA;145281;39;2021-05-12;89042
2021-05-11;"Bratislavský kraj";29;16741;32;16773;NA;145281;61;2021-05-11;89003
2021-05-10;"Bratislavský kraj";27;19991;64;20055;NA;145281;91;2021-05-10;88942
2021-05-09;"Bratislavský kraj";9;29358;32;29390;NA;145281;41;2021-05-09;88851
2021-05-08;"Bratislavský kraj";5;19451;24;19475;NA;145281;29;2021-05-08;88810
2021-05-07;"Bratislavský kraj";32;28211;65;28276;NA;145281;97;2021-05-07;88781
2021-05-06;"Bratislavský kraj";19;20079;52;20131;NA;145281;71;2021-05-06;88684
2021-05-05;"Bratislavský kraj";29;15526;31;15557;NA;145281;60;2021-05-05;88613
2021-05-04;"Bratislavský kraj";46;19143;53;19196;NA;145281;99;2021-05-04;88553
2021-05-03;"Bratislavský kraj";37;22322;64;22386;NA;145281;101;2021-05-03;88454
2021-05-02;"Bratislavský kraj";38;43064;75;43139;NA;145281;113;2021-05-02;88353
2021-05-01;"Bratislavský kraj";11;39905;40;39945;NA;145281;51;2021-05-01;88240
2021-04-30;"Bratislavský kraj";43;47403;82;47485;NA;145281;125;2021-04-30;88189
2021-04-29;"Bratislavský kraj";48;30257;96;30353;NA;145281;144;2021-04-29;88064
2021-04-28;"Bratislavský kraj";40;28905;78;28983;NA;145281;118;2021-04-28;87920
2021-04-27;"Bratislavský kraj";41;30168;52;30220;NA;145281;93;2021-04-27;87802
2021-04-26;"Bratislavský kraj";59;34733;97;34830;NA;145281;156;2021-04-26;87709
2021-04-25;"Bratislavský kraj";8;57615;74;57689;NA;145281;82;2021-04-25;87553
2021-04-24;"Bratislavský kraj";28;74858;66;74924;NA;145281;94;2021-04-24;87471
2021-04-23;"Bratislavský kraj";70;48614;62;48676;NA;145281;132;2021-04-23;87377
2021-04-22;"Bratislavský kraj";39;31037;72;31109;NA;145281;111;2021-04-22;87245
2021-04-21;"Bratislavský kraj";48;30442;62;30504;NA;145281;110;2021-04-21;87134
2021-04-20;"Bratislavský kraj";58;35216;63;35279;NA;145281;121;2021-04-20;87024
2021-04-19;"Bratislavský kraj";48;39500;80;39580;NA;145281;128;2021-04-19;86903
2021-04-18;"Bratislavský kraj";35;62300;76;62376;NA;145281;111;2021-04-18;86775
2021-04-17;"Bratislavský kraj";13;80359;111;80470;NA;145281;124;2021-04-17;86664
2021-04-16;"Bratislavský kraj";62;47296;80;47376;NA;145281;142;2021-04-16;86540
2021-04-15;"Bratislavský kraj";34;32176;74;32250;NA;145281;108;2021-04-15;86398
2021-04-14;"Bratislavský kraj";65;33961;88;34049;NA;145281;153;2021-04-14;86290
2021-04-13;"Bratislavský kraj";82;35512;82;35594;NA;145281;164;2021-04-13;86137
2021-04-12;"Bratislavský kraj";77;42286;115;42401;NA;145281;192;2021-04-12;85973
2021-04-11;"Bratislavský kraj";42;61151;123;61274;NA;145281;165;2021-04-11;85781
2021-04-10;"Bratislavský kraj";14;77874;167;78041;NA;145281;181;2021-04-10;85616
2021-04-09;"Bratislavský kraj";72;41556;97;41653;NA;145281;169;2021-04-09;85435
2021-04-08;"Bratislavský kraj";71;28866;95;28961;NA;145281;166;2021-04-08;85266
2021-04-07;"Bratislavský kraj";96;38061;101;38162;NA;145281;197;2021-04-07;85100
2021-04-06;"Bratislavský kraj";94;56204;179;56383;NA;145281;273;2021-04-06;84903
2021-04-05;"Bratislavský kraj";85;18538;85;18623;NA;145281;170;2021-04-05;84630
2021-04-04;"Bratislavský kraj";37;29225;75;29300;NA;145281;112;2021-04-04;84460
2021-04-03;"Bratislavský kraj";52;79865;220;80085;NA;145281;272;2021-04-03;84348
2021-04-02;"Bratislavský kraj";33;23790;104;23894;NA;145281;137;2021-04-02;84076
2021-04-01;"Bratislavský kraj";119;57388;159;57547;NA;145281;278;2021-04-01;83939
2021-03-31;"Bratislavský kraj";105;46371;177;46548;NA;145281;282;2021-03-31;83661
2021-03-30;"Bratislavský kraj";100;39599;144;39743;NA;145281;244;2021-03-30;83379
2021-03-29;"Bratislavský kraj";153;40364;178;40542;NA;145281;331;2021-03-29;83135
2021-03-28;"Bratislavský kraj";59;53372;137;53509;NA;145281;196;2021-03-28;82804
2021-03-27;"Bratislavský kraj";53;79834;240;80074;NA;145281;293;2021-03-27;82608
2021-03-26;"Bratislavský kraj";114;56108;191;56299;NA;145281;305;2021-03-26;82315
2021-03-25;"Bratislavský kraj";76;36859;172;37031;NA;145281;248;2021-03-25;82010
2021-03-24;"Bratislavský kraj";120;30567;201;30768;NA;145281;321;2021-03-24;81762
2021-03-23;"Bratislavský kraj";138;36438;190;36628;NA;145281;328;2021-03-23;81441
2021-03-22;"Bratislavský kraj";110;42756;220;42976;NA;145281;330;2021-03-22;81113
2021-03-21;"Bratislavský kraj";54;61299;212;61511;NA;145281;266;2021-03-21;80783
2021-03-20;"Bratislavský kraj";59;73300;228;73528;NA;145281;287;2021-03-20;80517
2021-03-19;"Bratislavský kraj";139;54576;257;54833;NA;145281;396;2021-03-19;80230
2021-03-18;"Bratislavský kraj";142;34611;192;34803;NA;145281;334;2021-03-18;79834
2021-03-17;"Bratislavský kraj";177;30482;217;30699;NA;145281;394;2021-03-17;79500
2021-03-16;"Bratislavský kraj";258;36798;287;37085;NA;145281;545;2021-03-16;79106
2021-03-15;"Bratislavský kraj";180;38226;255;38481;NA;145281;435;2021-03-15;78561
2021-03-14;"Bratislavský kraj";75;52611;275;52886;NA;145281;350;2021-03-14;78126
2021-03-13;"Bratislavský kraj";110;81405;341;81746;NA;145281;451;2021-03-13;77776
2021-03-12;"Bratislavský kraj";152;55233;312;55545;NA;145281;464;2021-03-12;77325
2021-03-11;"Bratislavský kraj";178;34678;286;34964;NA;145281;464;2021-03-11;76861
2021-03-10;"Bratislavský kraj";164;31061;280;31341;NA;145281;444;2021-03-10;76397
2021-03-09;"Bratislavský kraj";242;37687;267;37954;NA;145281;509;2021-03-09;75953
2021-03-08;"Bratislavský kraj";255;41199;348;41547;NA;145281;603;2021-03-08;75444
2021-03-07;"Bratislavský kraj";142;52812;301;53113;NA;145281;443;2021-03-07;74841
2021-03-06;"Bratislavský kraj";79;71821;415;72236;NA;145281;494;2021-03-06;74398
2021-03-05;"Bratislavský kraj";238;50840;294;51134;NA;145281;532;2021-03-05;73904
2021-03-04;"Bratislavský kraj";204;34544;344;34888;NA;145281;548;2021-03-04;73372
2021-03-03;"Bratislavský kraj";250;30527;364;30891;NA;145281;614;2021-03-03;72824
2021-03-02;"Bratislavský kraj";267;39735;388;40123;NA;145281;655;2021-03-02;72210
2021-03-01;"Bratislavský kraj";320;38222;432;38654;NA;145281;752;2021-03-01;71555
2021-02-28;"Bratislavský kraj";184;50323;323;50646;NA;145281;507;2021-02-28;70803
2021-02-27;"Bratislavský kraj";151;76580;464;77044;NA;145281;615;2021-02-27;70296
2021-02-26;"Bratislavský kraj";277;47326;401;47727;NA;145281;678;2021-02-26;69681
2021-02-25;"Bratislavský kraj";277;28769;405;29174;NA;145281;682;2021-02-25;69003
2021-02-24;"Bratislavský kraj";217;27095;412;27507;NA;145281;629;2021-02-24;68321
2021-02-23;"Bratislavský kraj";257;31297;395;31692;NA;145281;652;2021-02-23;67692
2021-02-22;"Bratislavský kraj";353;36607;483;37090;NA;145281;836;2021-02-22;67040
2021-02-21;"Bratislavský kraj";185;54150;396;54546;NA;145281;581;2021-02-21;66204
2021-02-20;"Bratislavský kraj";167;74814;550;75364;NA;145281;717;2021-02-20;65623
2021-02-19;"Bratislavský kraj";280;44882;416;45298;NA;145281;696;2021-02-19;64906
2021-02-18;"Bratislavský kraj";263;26379;371;26750;NA;145281;634;2021-02-18;64210
2021-02-17;"Bratislavský kraj";264;22820;316;23136;NA;145281;580;2021-02-17;63576
2021-02-16;"Bratislavský kraj";289;28262;352;28614;NA;145281;641;2021-02-16;62996
2021-02-15;"Bratislavský kraj";248;36893;396;37289;NA;145281;644;2021-02-15;62355
2021-02-14;"Bratislavský kraj";153;47948;323;48271;NA;145281;476;2021-02-14;61711
2021-02-13;"Bratislavský kraj";173;68589;515;69104;NA;145281;688;2021-02-13;61235
2021-02-12;"Bratislavský kraj";282;35729;327;36056;NA;145281;609;2021-02-12;60547
2021-02-11;"Bratislavský kraj";337;24565;285;24850;NA;145281;622;2021-02-11;59938
2021-02-10;"Bratislavský kraj";314;22944;356;23300;NA;145281;670;2021-02-10;59316
2021-02-09;"Bratislavský kraj";288;36565;454;37019;NA;145281;742;2021-02-09;58646
2021-02-08;"Bratislavský kraj";484;31896;397;32293;NA;145281;881;2021-02-08;57904
2021-02-07;"Bratislavský kraj";243;51290;425;51715;NA;145281;668;2021-02-07;57023
2021-02-06;"Bratislavský kraj";116;61682;501;62183;NA;145281;617;2021-02-06;56355
2021-02-05;"Bratislavský kraj";327;27033;375;27408;NA;145281;702;2021-02-05;55738
2021-02-04;"Bratislavský kraj";555;17260;348;17608;NA;145281;903;2021-02-04;55036
2021-02-03;"Bratislavský kraj";161;13020;352;13372;NA;145281;513;2021-02-03;54133
2021-02-02;"Bratislavský kraj";397;25947;480;26427;NA;145281;877;2021-02-02;53620
2021-02-01;"Bratislavský kraj";221;35541;513;36054;NA;145281;734;2021-02-01;52743
2021-01-31;"Bratislavský kraj";180;35693;425;36118;NA;145281;605;2021-01-31;52009
2021-01-30;"Bratislavský kraj";310;49588;521;50109;NA;145281;831;2021-01-30;51404
2021-01-29;"Bratislavský kraj";344;16568;344;16912;NA;145281;688;2021-01-29;50573
2021-01-28;"Bratislavský kraj";307;10715;297;11012;NA;145281;604;2021-01-28;49885
2021-01-27;"Bratislavský kraj";336;22222;345;22567;NA;145281;681;2021-01-27;49281
2021-01-26;"Bratislavský kraj";297;21894;300;22194;NA;145281;597;2021-01-26;48600
2021-01-25;"Bratislavský kraj";356;23335;249;23584;NA;145281;605;2021-01-25;48003
2021-01-24;"Bratislavský kraj";175;37903;404;38307;NA;145281;579;2021-01-24;47398
2021-01-23;"Bratislavský kraj";396;79453;690;80143;NA;145281;1086;2021-01-23;46819
2021-01-22;"Bratislavský kraj";199;42055;365;42420;NA;145281;564;2021-01-22;45733
2021-01-21;"Bratislavský kraj";255;105746;1317;107063;NA;145281;1572;2021-01-21;45169
2021-01-20;"Bratislavský kraj";360;27289;452;27741;NA;145281;812;2021-01-20;43597
2021-01-19;"Bratislavský kraj";375;15318;346;15664;NA;145281;721;2021-01-19;42785
2021-01-18;"Bratislavský kraj";357;12533;707;13240;NA;145281;1064;2021-01-18;42064
2021-01-17;"Bratislavský kraj";244;482;26;508;NA;145281;270;2021-01-17;41000
2021-01-16;"Bratislavský kraj";70;3016;156;3172;NA;145281;226;2021-01-16;40730
2021-01-15;"Bratislavský kraj";251;7896;256;8152;NA;145281;507;2021-01-15;40504
2021-01-14;"Bratislavský kraj";363;8523;273;8796;NA;145281;636;2021-01-14;39997
2021-01-13;"Bratislavský kraj";336;8490;327;8817;NA;145281;663;2021-01-13;39361
2021-01-12;"Bratislavský kraj";450;10509;455;10964;NA;145281;905;2021-01-12;38698
2021-01-11;"Bratislavský kraj";397;19863;364;20227;NA;145281;761;2021-01-11;37793
2021-01-10;"Bratislavský kraj";252;1507;79;1586;NA;145281;331;2021-01-10;37032
2021-01-09;"Bratislavský kraj";351;4721;277;4998;NA;145281;628;2021-01-09;36701
2021-01-08;"Bratislavský kraj";556;10045;436;10481;NA;145281;992;2021-01-08;36073
2021-01-07;"Bratislavský kraj";537;6872;352;7224;NA;145281;889;2021-01-07;35081
2021-01-06;"Bratislavský kraj";271;3329;216;3545;NA;145281;487;2021-01-06;34192
2021-01-05;"Bratislavský kraj";619;10635;814;11449;NA;145281;1433;2021-01-05;33705
2021-01-04;"Bratislavský kraj";601;8226;538;8764;NA;145281;1139;2021-01-04;32272
2021-01-03;"Bratislavský kraj";77;433;41;474;NA;145281;118;2021-01-03;31133
2021-01-02;"Bratislavský kraj";185;462;57;519;NA;145281;242;2021-01-02;31015
2021-01-01;"Bratislavský kraj";235;3277;131;3408;NA;145281;366;2021-01-01;30773
2020-12-31;"Bratislavský kraj";925;14135;519;14654;NA;145281;1444;2020-12-31;30407
2020-12-30;"Bratislavský kraj";650;9164;533;9697;NA;145281;1183;2020-12-30;28963
2020-12-29;"Bratislavský kraj";303;10108;699;10807;NA;145281;1002;2020-12-29;27780
2020-12-28;"Bratislavský kraj";255;7784;473;8257;NA;145281;728;2020-12-28;26778
2020-12-27;"Bratislavský kraj";160;709;76;785;NA;145281;236;2020-12-27;26050
2020-12-26;"Bratislavský kraj";75;480;27;507;NA;145281;102;2020-12-26;25814
2020-12-25;"Bratislavský kraj";114;503;38;541;NA;145281;152;2020-12-25;25712
2020-12-24;"Bratislavský kraj";536;3367;104;3471;NA;145281;640;2020-12-24;25560
2020-12-23;"Bratislavský kraj";416;12590;447;13037;NA;145281;863;2020-12-23;24920
2020-12-22;"Bratislavský kraj";327;14587;699;15286;NA;145281;1026;2020-12-22;24057
2020-12-21;"Bratislavský kraj";392;14972;1946;16918;NA;145281;2338;2020-12-21;23031
2020-12-20;"Bratislavský kraj";180;797;57;854;NA;145281;237;2020-12-20;20693
2020-12-19;"Bratislavský kraj";396;3314;130;3444;NA;145281;526;2020-12-19;20456
2020-12-18;"Bratislavský kraj";306;9938;345;10283;NA;145281;651;2020-12-18;19930
2020-12-17;"Bratislavský kraj";502;9739;386;10125;NA;145281;888;2020-12-17;19279
2020-12-16;"Bratislavský kraj";282;10201;418;10619;NA;145281;700;2020-12-16;18391
2020-12-15;"Bratislavský kraj";423;10450;454;10904;NA;145281;877;2020-12-15;17691
2020-12-14;"Bratislavský kraj";279;6793;261;7054;NA;145281;540;2020-12-14;16814
2020-12-13;"Bratislavský kraj";125;139;10;149;NA;145281;135;2020-12-13;16274
2020-12-12;"Bratislavský kraj";361;3886;157;4043;NA;145281;518;2020-12-12;16139
2020-12-11;"Bratislavský kraj";326;6824;235;7059;NA;145281;561;2020-12-11;15621
2020-12-10;"Bratislavský kraj";286;5279;166;5445;NA;145281;452;2020-12-10;15060
2020-12-09;"Bratislavský kraj";382;4778;177;4955;NA;145281;559;2020-12-09;14608
2020-12-08;"Bratislavský kraj";234;6243;207;6450;NA;145281;441;2020-12-08;14049
2020-12-07;"Bratislavský kraj";272;4639;152;4791;NA;145281;424;2020-12-07;13608
2020-12-06;"Bratislavský kraj";61;1625;52;1677;NA;145281;113;2020-12-06;13184
2020-12-05;"Bratislavský kraj";266;2221;41;2262;NA;145281;307;2020-12-05;13071
2020-12-04;"Bratislavský kraj";200;4954;99;5053;NA;145281;299;2020-12-04;12764
2020-12-03;"Bratislavský kraj";213;5672;95;5767;NA;145281;308;2020-12-03;12465
2020-12-02;"Bratislavský kraj";205;3462;103;3565;NA;145281;308;2020-12-02;12157
2020-12-01;"Bratislavský kraj";255;3889;172;4061;NA;145281;427;2020-12-01;11849
2020-11-30;"Bratislavský kraj";152;2153;121;2274;NA;145281;273;2020-11-30;11422
2020-11-29;"Bratislavský kraj";52;201;24;225;NA;145281;76;2020-11-29;11149
2020-11-28;"Bratislavský kraj";232;2624;33;2657;NA;145281;265;2020-11-28;11073
2020-11-27;"Bratislavský kraj";54;2540;64;2604;NA;145281;118;2020-11-27;10808
2020-11-26;"Bratislavský kraj";129;1976;60;2036;NA;145281;189;2020-11-26;10690
2020-11-25;"Bratislavský kraj";140;1770;47;1817;NA;145281;187;2020-11-25;10501
2020-11-24;"Bratislavský kraj";81;2988;67;3055;NA;145281;148;2020-11-24;10314
2020-11-23;"Bratislavský kraj";67;7083;58;7141;NA;145281;125;2020-11-23;10166
2020-11-22;"Bratislavský kraj";36;81;7;88;NA;145281;43;2020-11-22;10041
2020-11-21;"Bratislavský kraj";109;2126;47;2173;NA;145281;156;2020-11-21;9998
2020-11-20;"Bratislavský kraj";118;2876;48;2924;NA;145281;166;2020-11-20;9842
2020-11-19;"Bratislavský kraj";173;987;29;1016;NA;145281;202;2020-11-19;9676
2020-11-18;"Bratislavský kraj";118;616;75;691;NA;145281;193;2020-11-18;9474
2020-11-17;"Bratislavský kraj";108;928;23;951;NA;145281;131;2020-11-17;9281
2020-11-16;"Bratislavský kraj";82;651;9;660;NA;145281;91;2020-11-16;9150
2020-11-15;"Bratislavský kraj";47;236;0;236;NA;145281;47;2020-11-15;9059
2020-11-14;"Bratislavský kraj";53;1834;15;1849;NA;145281;68;2020-11-14;9012
2020-11-13;"Bratislavský kraj";94;2096;21;2117;NA;145281;115;2020-11-13;8944
2020-11-12;"Bratislavský kraj";141;1727;6;1733;NA;145281;147;2020-11-12;8829
2020-11-11;"Bratislavský kraj";159;1429;12;1441;NA;145281;171;2020-11-11;8682
2020-11-10;"Bratislavský kraj";136;805;14;819;NA;145281;150;2020-11-10;8511
2020-11-09;"Bratislavský kraj";70;616;8;624;NA;145281;78;2020-11-09;8361
2020-11-08;"Bratislavský kraj";82;869;6;875;NA;145281;88;2020-11-08;8283
2020-11-07;"Bratislavský kraj";88;4039;17;4056;NA;145281;105;2020-11-07;8195
2020-11-06;"Bratislavský kraj";281;6441;25;6466;NA;145281;306;2020-11-06;8090
2020-11-05;"Bratislavský kraj";175;476;11;487;NA;145281;186;2020-11-05;7784
2020-11-04;"Bratislavský kraj";65;411;10;421;NA;145281;75;2020-11-04;7598
2020-11-03;"Bratislavský kraj";251;1085;12;1097;NA;145281;263;2020-11-03;7523
2020-11-02;"Bratislavský kraj";202;3365;22;3387;NA;145281;224;2020-11-02;7260
2020-11-01;"Bratislavský kraj";227;8694;39;8733;NA;145281;266;2020-11-01;7036
2020-10-31;"Bratislavský kraj";173;22407;123;22530;NA;145281;296;2020-10-31;6770
2020-10-30;"Bratislavský kraj";158;17350;138;17488;NA;145281;296;2020-10-30;6474
2020-10-29;"Bratislavský kraj";262;116;4;120;NA;145281;266;2020-10-29;6178
2020-10-28;"Bratislavský kraj";220;260;15;275;NA;145281;235;2020-10-28;5912
2020-10-27;"Bratislavský kraj";256;145;4;149;NA;145281;260;2020-10-27;5677
2020-10-26;"Bratislavský kraj";123;229;11;240;NA;145281;134;2020-10-26;5417
2020-10-25;"Bratislavský kraj";152;33;2;35;NA;145281;154;2020-10-25;5283
2020-10-24;"Bratislavský kraj";170;221;6;227;NA;145281;176;2020-10-24;5129
2020-10-23;"Bratislavský kraj";151;144;8;152;NA;145281;159;2020-10-23;4953
2020-10-22;"Bratislavský kraj";192;204;15;219;NA;145281;207;2020-10-22;4794
2020-10-21;"Bratislavský kraj";66;90;6;96;NA;145281;72;2020-10-21;4587
2020-10-20;"Bratislavský kraj";183;97;4;101;NA;145281;187;2020-10-20;4515
2020-10-19;"Bratislavský kraj";148;80;3;83;NA;145281;151;2020-10-19;4328
2020-10-18;"Bratislavský kraj";75;92;0;92;NA;145281;75;2020-10-18;4177
2020-10-17;"Bratislavský kraj";136;0;0;0;NA;145281;136;2020-10-17;4102
2020-10-16;"Bratislavský kraj";103;14;1;15;NA;145281;104;2020-10-16;3966
2020-10-15;"Bratislavský kraj";135;6;1;7;NA;145281;136;2020-10-15;3862
2020-10-14;"Bratislavský kraj";127;4;0;4;NA;145281;127;2020-10-14;3726
2020-10-13;"Bratislavský kraj";86;108;8;116;NA;145281;94;2020-10-13;3599
2020-10-12;"Bratislavský kraj";46;0;0;0;NA;145281;46;2020-10-12;3505
2020-10-11;"Bratislavský kraj";80;0;0;0;NA;145281;80;2020-10-11;3459
2020-10-10;"Bratislavský kraj";55;0;0;0;NA;145281;55;2020-10-10;3379
2020-10-09;"Bratislavský kraj";148;0;0;0;NA;145281;148;2020-10-09;3324
2020-10-08;"Bratislavský kraj";100;0;0;0;NA;145281;100;2020-10-08;3176
2020-10-07;"Bratislavský kraj";107;0;0;0;NA;145281;107;2020-10-07;3076
2020-10-06;"Bratislavský kraj";108;0;0;0;NA;145281;108;2020-10-06;2969
2020-10-05;"Bratislavský kraj";30;0;0;0;NA;145281;30;2020-10-05;2861
2020-10-04;"Bratislavský kraj";49;0;0;0;NA;145281;49;2020-10-04;2831
2020-10-03;"Bratislavský kraj";82;0;0;0;NA;145281;82;2020-10-03;2782
2020-10-02;"Bratislavský kraj";101;0;0;0;NA;145281;101;2020-10-02;2700
2020-10-01;"Bratislavský kraj";72;0;0;0;NA;145281;72;2020-10-01;2599
2020-09-30;"Bratislavský kraj";91;0;0;0;NA;145281;91;2020-09-30;2527
2020-09-29;"Bratislavský kraj";74;0;0;0;NA;145281;74;2020-09-29;2436
2020-09-28;"Bratislavský kraj";29;0;0;0;NA;145281;29;2020-09-28;2362
2020-09-27;"Bratislavský kraj";48;0;0;0;NA;145281;48;2020-09-27;2333
2020-09-26;"Bratislavský kraj";86;0;0;0;NA;145281;86;2020-09-26;2285
2020-09-25;"Bratislavský kraj";97;0;0;0;NA;145281;97;2020-09-25;2199
2020-09-24;"Bratislavský kraj";73;0;0;0;NA;145281;73;2020-09-24;2102
2020-09-23;"Bratislavský kraj";55;0;0;0;NA;145281;55;2020-09-23;2029
2020-09-22;"Bratislavský kraj";81;0;0;0;NA;145281;81;2020-09-22;1974
2020-09-21;"Bratislavský kraj";32;0;0;0;NA;145281;32;2020-09-21;1893
2020-09-20;"Bratislavský kraj";25;0;0;0;NA;145281;25;2020-09-20;1861
2020-09-19;"Bratislavský kraj";59;0;0;0;NA;145281;59;2020-09-19;1836
2020-09-18;"Bratislavský kraj";42;0;0;0;NA;145281;42;2020-09-18;1777
2020-09-17;"Bratislavský kraj";52;0;0;0;NA;145281;52;2020-09-17;1735
2020-09-16;"Bratislavský kraj";32;0;0;0;NA;145281;32;2020-09-16;1683
2020-09-15;"Bratislavský kraj";26;0;0;0;NA;145281;26;2020-09-15;1651
2020-09-14;"Bratislavský kraj";24;0;0;0;NA;145281;24;2020-09-14;1625
2020-09-13;"Bratislavský kraj";11;0;0;0;NA;145281;11;2020-09-13;1601
2020-09-12;"Bratislavský kraj";24;0;0;0;NA;145281;24;2020-09-12;1590
2020-09-11;"Bratislavský kraj";50;0;0;0;NA;145281;50;2020-09-11;1566
2020-09-10;"Bratislavský kraj";47;0;0;0;NA;145281;47;2020-09-10;1516
2020-09-09;"Bratislavský kraj";40;0;0;0;NA;145281;40;2020-09-09;1469
2020-09-08;"Bratislavský kraj";58;0;0;0;NA;145281;58;2020-09-08;1429
2020-09-07;"Bratislavský kraj";39;0;0;0;NA;145281;39;2020-09-07;1371
2020-09-06;"Bratislavský kraj";11;0;0;0;NA;145281;11;2020-09-06;1332
2020-09-05;"Bratislavský kraj";37;0;0;0;NA;145281;37;2020-09-05;1321
2020-09-04;"Bratislavský kraj";87;0;0;0;NA;145281;87;2020-09-04;1284
2020-09-03;"Bratislavský kraj";51;0;0;0;NA;145281;51;2020-09-03;1197
2020-09-02;"Bratislavský kraj";50;0;0;0;NA;145281;50;2020-09-02;1146
2020-09-01;"Bratislavský kraj";16;0;0;0;NA;145281;16;2020-09-01;1096
2020-08-31;"Bratislavský kraj";19;0;0;0;NA;145281;19;2020-08-31;1080
2020-08-30;"Bratislavský kraj";9;0;0;0;NA;145281;9;2020-08-30;1061
2020-08-29;"Bratislavský kraj";12;0;0;0;NA;145281;12;2020-08-29;1052
2020-08-28;"Bratislavský kraj";35;0;0;0;NA;145281;35;2020-08-28;1040
2020-08-27;"Bratislavský kraj";33;0;0;0;NA;145281;33;2020-08-27;1005
2020-08-26;"Bratislavský kraj";27;0;0;0;NA;145281;27;2020-08-26;972
2020-08-25;"Bratislavský kraj";29;0;0;0;NA;145281;29;2020-08-25;945
2020-08-24;"Bratislavský kraj";6;0;0;0;NA;145281;6;2020-08-24;916
2020-08-23;"Bratislavský kraj";45;0;0;0;NA;145281;45;2020-08-23;910
2020-08-22;"Bratislavský kraj";13;0;0;0;NA;145281;13;2020-08-22;865
2020-08-21;"Bratislavský kraj";46;0;0;0;NA;145281;46;2020-08-21;852
2020-08-20;"Bratislavský kraj";41;0;0;0;NA;145281;41;2020-08-20;806
2020-08-19;"Bratislavský kraj";27;0;0;0;NA;145281;27;2020-08-19;765
2020-08-18;"Bratislavský kraj";47;0;0;0;NA;145281;47;2020-08-18;738
2020-08-17;"Bratislavský kraj";2;0;0;0;NA;145281;2;2020-08-17;691
2020-08-16;"Bratislavský kraj";3;0;0;0;NA;145281;3;2020-08-16;689
2020-08-15;"Bratislavský kraj";18;0;0;0;NA;145281;18;2020-08-15;686
2020-08-14;"Bratislavský kraj";16;0;0;0;NA;145281;16;2020-08-14;668
2020-08-13;"Bratislavský kraj";12;0;0;0;NA;145281;12;2020-08-13;652
2020-08-12;"Bratislavský kraj";10;0;0;0;NA;145281;10;2020-08-12;640
2020-08-11;"Bratislavský kraj";23;0;0;0;NA;145281;23;2020-08-11;630
2020-08-10;"Bratislavský kraj";2;0;0;0;NA;145281;2;2020-08-10;607
2020-08-09;"Bratislavský kraj";2;0;0;0;NA;145281;2;2020-08-09;605
2020-08-08;"Bratislavský kraj";1;0;0;0;NA;145281;1;2020-08-08;603
2020-08-07;"Bratislavský kraj";9;0;0;0;NA;145281;9;2020-08-07;602
2020-08-06;"Bratislavský kraj";15;0;0;0;NA;145281;15;2020-08-06;593
2020-08-05;"Bratislavský kraj";11;0;0;0;NA;145281;11;2020-08-05;578
2020-08-04;"Bratislavský kraj";21;0;0;0;NA;145281;21;2020-08-04;567
2020-08-03;"Bratislavský kraj";7;0;0;0;NA;145281;7;2020-08-03;546
2020-08-02;"Bratislavský kraj";0;0;0;0;NA;145281;0;2020-08-02;539
2020-08-01;"Bratislavský kraj";0;0;0;0;NA;145281;0;2020-08-01;539
2020-07-31;"Bratislavský kraj";14;0;0;0;NA;145281;14;2020-07-31;539
2020-07-30;"Bratislavský kraj";6;0;0;0;NA;145281;6;2020-07-30;525
2020-07-29;"Bratislavský kraj";7;0;0;0;NA;145281;7;2020-07-29;519
2020-07-28;"Bratislavský kraj";14;0;0;0;NA;145281;14;2020-07-28;512
2020-07-27;"Bratislavský kraj";3;0;0;0;NA;145281;3;2020-07-27;498
2020-07-26;"Bratislavský kraj";0;0;0;0;NA;145281;0;2020-07-26;495
2020-07-25;"Bratislavský kraj";8;0;0;0;NA;145281;8;2020-07-25;495
2020-07-24;"Bratislavský kraj";2;0;0;0;NA;145281;2;2020-07-24;487
2020-07-23;"Bratislavský kraj";8;0;0;0;NA;145281;8;2020-07-23;485
2020-07-22;"Bratislavský kraj";11;0;0;0;NA;145281;11;2020-07-22;477
2020-07-21;"Bratislavský kraj";8;0;0;0;NA;145281;8;2020-07-21;466
2020-07-20;"Bratislavský kraj";12;0;0;0;NA;145281;12;2020-07-20;458
2020-07-19;"Bratislavský kraj";0;0;0;0;NA;145281;0;2020-07-19;446
2020-07-18;"Bratislavský kraj";2;0;0;0;NA;145281;2;2020-07-18;446
2020-07-17;"Bratislavský kraj";2;0;0;0;NA;145281;2;2020-07-17;444
2020-07-16;"Bratislavský kraj";6;0;0;0;NA;145281;6;2020-07-16;442
2020-07-15;"Bratislavský kraj";3;0;0;0;NA;145281;3;2020-07-15;436
2020-07-14;"Bratislavský kraj";2;0;0;0;NA;145281;2;2020-07-14;433
2020-07-13;"Bratislavský kraj";2;0;0;0;NA;145281;2;2020-07-13;431
2020-07-12;"Bratislavský kraj";0;0;0;0;NA;145281;0;2020-07-12;429
2020-07-11;"Bratislavský kraj";0;0;0;0;NA;145281;0;2020-07-11;429
2020-07-10;"Bratislavský kraj";8;0;0;0;NA;145281;8;2020-07-10;429
2020-07-09;"Bratislavský kraj";2;0;0;0;NA;145281;2;2020-07-09;421
2020-07-08;"Bratislavský kraj";11;0;0;0;NA;145281;11;2020-07-08;419
2020-07-07;"Bratislavský kraj";5;0;0;0;NA;145281;5;2020-07-07;408
2020-07-06;"Bratislavský kraj";1;0;0;0;NA;145281;1;2020-07-06;403
2020-07-05;"Bratislavský kraj";0;0;0;0;NA;145281;0;2020-07-05;402
2020-07-04;"Bratislavský kraj";3;0;0;0;NA;145281;3;2020-07-04;402
2020-07-03;"Bratislavský kraj";1;0;0;0;NA;145281;1;2020-07-03;399
2020-07-02;"Bratislavský kraj";0;0;0;0;NA;145281;0;2020-07-02;398
2020-07-01;"Bratislavský kraj";7;0;0;0;NA;145281;7;2020-07-01;398
2020-06-30;"Bratislavský kraj";3;0;0;0;NA;145281;3;2020-06-30;391
2020-06-29;"Bratislavský kraj";1;0;0;0;NA;145281;1;2020-06-29;388
2020-06-28;"Bratislavský kraj";0;0;0;0;NA;145281;0;2020-06-28;387
2020-06-27;"Bratislavský kraj";1;0;0;0;NA;145281;1;2020-06-27;387
2020-06-26;"Bratislavský kraj";6;0;0;0;NA;145281;6;2020-06-26;386
2020-06-25;"Bratislavský kraj";0;0;0;0;NA;145281;0;2020-06-25;380
2020-06-24;"Bratislavský kraj";3;0;0;0;NA;145281;3;2020-06-24;380
2020-06-23;"Bratislavský kraj";0;0;0;0;NA;145281;0;2020-06-23;377
2020-06-22;"Bratislavský kraj";1;0;0;0;NA;145281;1;2020-06-22;377
2020-06-21;"Bratislavský kraj";0;0;0;0;NA;145281;0;2020-06-21;376
2020-06-20;"Bratislavský kraj";0;0;0;0;NA;145281;0;2020-06-20;376
2020-06-19;"Bratislavský kraj";3;0;0;0;NA;145281;3;2020-06-19;376
2020-06-18;"Bratislavský kraj";0;0;0;0;NA;145281;0;2020-06-18;373
2020-06-17;"Bratislavský kraj";0;0;0;0;NA;145281;0;2020-06-17;373
2020-06-16;"Bratislavský kraj";0;0;0;0;NA;145281;0;2020-06-16;373
2020-06-14;"Bratislavský kraj";2;0;0;0;NA;145281;2;2020-06-14;373
2020-06-13;"Bratislavský kraj";1;0;0;0;NA;145281;1;2020-06-13;371
2020-06-12;"Bratislavský kraj";2;0;0;0;NA;145281;2;2020-06-12;370
2020-06-11;"Bratislavský kraj";0;0;0;0;NA;145281;0;2020-06-11;368
2020-06-10;"Bratislavský kraj";0;0;0;0;NA;145281;0;2020-06-10;368
2020-06-09;"Bratislavský kraj";0;0;0;0;NA;145281;0;2020-06-09;368
2020-06-08;"Bratislavský kraj";1;0;0;0;NA;145281;1;2020-06-08;368
2020-06-07;"Bratislavský kraj";0;0;0;0;NA;145281;0;2020-06-07;367
2020-06-05;"Bratislavský kraj";0;0;0;0;NA;145281;0;2020-06-05;367
2020-06-03;"Bratislavský kraj";1;0;0;0;NA;145281;1;2020-06-03;367
2020-06-02;"Bratislavský kraj";0;0;0;0;NA;145281;0;2020-06-02;366
2020-05-31;"Bratislavský kraj";0;0;0;0;NA;145281;0;2020-05-31;366
2020-05-29;"Bratislavský kraj";0;0;0;0;NA;145281;0;2020-05-29;366
2020-05-27;"Bratislavský kraj";1;0;0;0;NA;145281;1;2020-05-27;366
2020-05-26;"Bratislavský kraj";0;0;0;0;NA;145281;0;2020-05-26;365
2020-05-25;"Bratislavský kraj";0;0;0;0;NA;145281;0;2020-05-25;365
2020-05-24;"Bratislavský kraj";0;0;0;0;NA;145281;0;2020-05-24;365
2020-05-23;"Bratislavský kraj";2;0;0;0;NA;145281;2;2020-05-23;365
2020-05-22;"Bratislavský kraj";0;0;0;0;NA;145281;0;2020-05-22;363
2020-05-21;"Bratislavský kraj";0;0;0;0;NA;145281;0;2020-05-21;363
2020-05-20;"Bratislavský kraj";0;0;0;0;NA;145281;0;2020-05-20;363
2020-05-19;"Bratislavský kraj";0;0;0;0;NA;145281;0;2020-05-19;363
2020-05-17;"Bratislavský kraj";0;0;0;0;NA;145281;0;2020-05-17;363
2020-05-16;"Bratislavský kraj";0;0;0;0;NA;145281;0;2020-05-16;363
2020-05-15;"Bratislavský kraj";0;0;0;0;NA;145281;0;2020-05-15;363
2020-05-14;"Bratislavský kraj";0;0;0;0;NA;145281;0;2020-05-14;363
2020-05-13;"Bratislavský kraj";0;0;0;0;NA;145281;0;2020-05-13;363
2020-05-12;"Bratislavský kraj";2;0;0;0;NA;145281;2;2020-05-12;363
2020-05-11;"Bratislavský kraj";0;0;0;0;NA;145281;0;2020-05-11;361
2020-05-09;"Bratislavský kraj";0;0;0;0;NA;145281;0;2020-05-09;361
2020-05-07;"Bratislavský kraj";1;0;0;0;NA;145281;1;2020-05-07;361
2020-05-06;"Bratislavský kraj";3;0;0;0;NA;145281;3;2020-05-06;360
2020-05-05;"Bratislavský kraj";0;0;0;0;NA;145281;0;2020-05-05;357
2020-05-04;"Bratislavský kraj";0;0;0;0;NA;145281;0;2020-05-04;357
2020-05-03;"Bratislavský kraj";2;0;0;0;NA;145281;2;2020-05-03;357
2020-05-02;"Bratislavský kraj";0;0;0;0;NA;145281;0;2020-05-02;355
2020-05-01;"Bratislavský kraj";0;0;0;0;NA;145281;0;2020-05-01;355
2020-04-30;"Bratislavský kraj";5;0;0;0;NA;145281;5;2020-04-30;355
2020-04-29;"Bratislavský kraj";0;0;0;0;NA;145281;0;2020-04-29;350
2020-04-28;"Bratislavský kraj";2;0;0;0;NA;145281;2;2020-04-28;350
2020-04-27;"Bratislavský kraj";0;0;0;0;NA;145281;0;2020-04-27;348
2020-04-26;"Bratislavský kraj";1;0;0;0;NA;145281;1;2020-04-26;348
2020-04-25;"Bratislavský kraj";0;0;0;0;NA;145281;0;2020-04-25;347
2020-04-24;"Bratislavský kraj";2;0;0;0;NA;145281;2;2020-04-24;347
2020-04-23;"Bratislavský kraj";6;0;0;0;NA;145281;6;2020-04-23;345
2020-04-22;"Bratislavský kraj";11;0;0;0;NA;145281;11;2020-04-22;339
2020-04-21;"Bratislavský kraj";4;0;0;0;NA;145281;4;2020-04-21;328
2020-04-20;"Bratislavský kraj";0;0;0;0;NA;145281;0;2020-04-20;324
2020-04-19;"Bratislavský kraj";4;0;0;0;NA;145281;4;2020-04-19;324
2020-04-18;"Bratislavský kraj";5;0;0;0;NA;145281;5;2020-04-18;320
2020-04-17;"Bratislavský kraj";6;0;0;0;NA;145281;6;2020-04-17;315
2020-04-16;"Bratislavský kraj";15;0;0;0;NA;145281;15;2020-04-16;309
2020-04-15;"Bratislavský kraj";11;0;0;0;NA;145281;11;2020-04-15;294
2020-04-14;"Bratislavský kraj";19;0;0;0;NA;145281;19;2020-04-14;283
2020-04-13;"Bratislavský kraj";53;0;0;0;NA;145281;53;2020-04-13;264
2020-04-12;"Bratislavský kraj";3;0;0;0;NA;145281;3;2020-04-12;211
2020-04-11;"Bratislavský kraj";1;0;0;0;NA;145281;1;2020-04-11;208
2020-04-10;"Bratislavský kraj";8;0;0;0;NA;145281;8;2020-04-10;207
2020-04-09;"Bratislavský kraj";3;0;0;0;NA;145281;3;2020-04-09;199
2020-04-08;"Bratislavský kraj";3;0;0;0;NA;145281;3;2020-04-08;196
2020-04-07;"Bratislavský kraj";24;0;0;0;NA;145281;24;2020-04-07;193
2020-04-06;"Bratislavský kraj";5;0;0;0;NA;145281;5;2020-04-06;169
2020-04-05;"Bratislavský kraj";6;0;0;0;NA;145281;6;2020-04-05;164
2020-04-04;"Bratislavský kraj";2;0;0;0;NA;145281;2;2020-04-04;158
2020-04-03;"Bratislavský kraj";1;0;0;0;NA;145281;1;2020-04-03;156
2020-04-02;"Bratislavský kraj";2;0;0;0;NA;145281;2;2020-04-02;155
2020-04-01;"Bratislavský kraj";5;0;0;0;NA;145281;5;2020-04-01;153
2020-03-31;"Bratislavský kraj";19;0;0;0;NA;145281;19;2020-03-31;148
2020-03-30;"Bratislavský kraj";6;0;0;0;NA;145281;6;2020-03-30;129
2020-03-29;"Bratislavský kraj";8;0;0;0;NA;145281;8;2020-03-29;123
2020-03-28;"Bratislavský kraj";4;0;0;0;NA;145281;4;2020-03-28;115
2020-03-27;"Bratislavský kraj";3;0;0;0;NA;145281;3;2020-03-27;111
2020-03-26;"Bratislavský kraj";15;0;0;0;NA;145281;15;2020-03-26;108
2020-03-25;"Bratislavský kraj";1;0;0;0;NA;145281;1;2020-03-25;93
2020-03-24;"Bratislavský kraj";4;0;0;0;NA;145281;4;2020-03-24;92
2020-03-23;"Bratislavský kraj";9;0;0;0;NA;145281;9;2020-03-23;88
2020-03-22;"Bratislavský kraj";2;0;0;0;NA;145281;2;2020-03-22;79
2020-03-21;"Bratislavský kraj";22;0;0;0;NA;145281;22;2020-03-21;77
2020-03-20;"Bratislavský kraj";3;0;0;0;NA;145281;3;2020-03-20;55
2020-03-19;"Bratislavský kraj";4;0;0;0;NA;145281;4;2020-03-19;52
2020-03-18;"Bratislavský kraj";3;0;0;0;NA;145281;3;2020-03-18;48
2020-03-17;"Bratislavský kraj";13;0;0;0;NA;145281;13;2020-03-17;45
2020-03-16;"Bratislavský kraj";1;0;0;0;NA;145281;1;2020-03-16;32
2020-03-15;"Bratislavský kraj";4;0;0;0;NA;145281;4;2020-03-15;31
2020-03-14;"Bratislavský kraj";9;0;0;0;NA;145281;9;2020-03-14;27
2020-03-13;"Bratislavský kraj";2;0;0;0;NA;145281;2;2020-03-13;18
2020-03-12;"Bratislavský kraj";8;0;0;0;NA;145281;8;2020-03-12;16
2020-03-11;"Bratislavský kraj";3;0;0;0;NA;145281;3;2020-03-11;8
2020-03-09;"Bratislavský kraj";0;0;0;0;NA;145281;0;2020-03-09;5
2020-03-08;"Bratislavský kraj";2;0;0;0;NA;145281;2;2020-03-08;5
2020-03-07;"Bratislavský kraj";2;0;0;0;NA;145281;2;2020-03-07;3
2020-03-06;"Bratislavský kraj";1;0;0;0;NA;145281;1;2020-03-06;1
2021-12-02;"Košický kraj";2209;0;0;0;101303;164564;2209;2021-12-02;164564
2021-12-01;"Košický kraj";1016;4155;210;4365;NA;164564;1226;2021-12-01;162355
2021-11-30;"Košický kraj";1125;7678;438;8116;NA;164564;1563;2021-11-30;161129
2021-11-29;"Košický kraj";993;13015;585;13600;NA;164564;1578;2021-11-29;159566
2021-11-28;"Košický kraj";972;9625;445;10070;NA;164564;1417;2021-11-28;157988
2021-11-27;"Košický kraj";1103;3375;197;3572;NA;164564;1300;2021-11-27;156571
2021-11-26;"Košický kraj";1395;5800;363;6163;NA;164564;1758;2021-11-26;155271
2021-11-25;"Košický kraj";1373;6593;465;7058;NA;164564;1838;2021-11-25;153513
2021-11-24;"Košický kraj";1194;6573;437;7010;NA;164564;1631;2021-11-24;151675
2021-11-23;"Košický kraj";1178;6897;469;7366;NA;164564;1647;2021-11-23;150044
2021-11-22;"Košický kraj";861;10153;724;10877;NA;164564;1585;2021-11-22;148397
2021-11-21;"Košický kraj";985;6995;623;7618;NA;164564;1608;2021-11-21;146812
2021-11-20;"Košický kraj";1083;2636;275;2911;NA;164564;1358;2021-11-20;145204
2021-11-19;"Košický kraj";1078;7452;547;7999;NA;164564;1625;2021-11-19;143846
2021-11-18;"Košický kraj";1061;8898;700;9598;NA;164564;1761;2021-11-18;142221
2021-11-17;"Košický kraj";1319;2549;245;2794;NA;164564;1564;2021-11-17;140460
2021-11-16;"Košický kraj";1484;6827;520;7347;NA;164564;2004;2021-11-16;138896
2021-11-15;"Košický kraj";902;10382;731;11113;NA;164564;1633;2021-11-15;136892
2021-11-14;"Košický kraj";715;5327;441;5768;NA;164564;1156;2021-11-14;135259
2021-11-13;"Košický kraj";869;2508;293;2801;NA;164564;1162;2021-11-13;134103
2021-11-12;"Košický kraj";1132;5351;393;5744;NA;164564;1525;2021-11-12;132941
2021-11-11;"Košický kraj";1035;5876;445;6321;NA;164564;1480;2021-11-11;131416
2021-11-10;"Košický kraj";933;6396;482;6878;NA;164564;1415;2021-11-10;129936
2021-11-09;"Košický kraj";967;5264;362;5626;NA;164564;1329;2021-11-09;128521
2021-11-08;"Košický kraj";701;7838;601;8439;NA;164564;1302;2021-11-08;127192
2021-11-07;"Košický kraj";691;4336;415;4751;NA;164564;1106;2021-11-07;125890
2021-11-06;"Košický kraj";996;2132;210;2342;NA;164564;1206;2021-11-06;124784
2021-11-05;"Košický kraj";1029;4684;342;5026;NA;164564;1371;2021-11-05;123578
2021-11-04;"Košický kraj";1000;5098;345;5443;NA;164564;1345;2021-11-04;122207
2021-11-03;"Košický kraj";1051;5516;342;5858;NA;164564;1393;2021-11-03;120862
2021-11-02;"Košický kraj";915;8458;551;9009;NA;164564;1466;2021-11-02;119469
2021-11-01;"Košický kraj";181;1872;243;2115;NA;164564;424;2021-11-01;118003
2021-10-31;"Košický kraj";385;2188;220;2408;NA;164564;605;2021-10-31;117579
2021-10-30;"Košický kraj";641;2259;172;2431;NA;164564;813;2021-10-30;116974
2021-10-29;"Košický kraj";750;4412;284;4696;NA;164564;1034;2021-10-29;116161
2021-10-28;"Košický kraj";823;4913;244;5157;NA;164564;1067;2021-10-28;115127
2021-10-27;"Košický kraj";723;4606;250;4856;NA;164564;973;2021-10-27;114060
2021-10-26;"Košický kraj";618;4808;222;5030;NA;164564;840;2021-10-26;113087
2021-10-25;"Košický kraj";268;6520;282;6802;NA;164564;550;2021-10-25;112247
2021-10-24;"Košický kraj";170;3253;199;3452;NA;164564;369;2021-10-24;111697
2021-10-23;"Košický kraj";397;1819;82;1901;NA;164564;479;2021-10-23;111328
2021-10-22;"Košický kraj";474;4456;125;4581;NA;164564;599;2021-10-22;110849
2021-10-21;"Košický kraj";669;4858;164;5022;NA;164564;833;2021-10-21;110250
2021-10-20;"Košický kraj";398;4748;143;4891;NA;164564;541;2021-10-20;109417
2021-10-19;"Košický kraj";579;4685;158;4843;NA;164564;737;2021-10-19;108876
2021-10-18;"Košický kraj";180;6841;162;7003;NA;164564;342;2021-10-18;108139
2021-10-17;"Košický kraj";70;3459;116;3575;NA;164564;186;2021-10-17;107797
2021-10-16;"Košický kraj";312;1670;39;1709;NA;164564;351;2021-10-16;107611
2021-10-15;"Košický kraj";312;4288;73;4361;NA;164564;385;2021-10-15;107260
2021-10-14;"Košický kraj";327;4448;91;4539;NA;164564;418;2021-10-14;106875
2021-10-13;"Košický kraj";168;3958;84;4042;NA;164564;252;2021-10-13;106457
2021-10-12;"Košický kraj";391;3910;72;3982;NA;164564;463;2021-10-12;106205
2021-10-11;"Košický kraj";119;5881;109;5990;NA;164564;228;2021-10-11;105742
2021-10-10;"Košický kraj";104;2921;63;2984;NA;164564;167;2021-10-10;105514
2021-10-09;"Košický kraj";111;1547;41;1588;NA;164564;152;2021-10-09;105347
2021-10-08;"Košický kraj";274;3875;64;3939;NA;164564;338;2021-10-08;105195
2021-10-07;"Košický kraj";277;4211;72;4283;NA;164564;349;2021-10-07;104857
2021-10-06;"Košický kraj";178;4150;81;4231;NA;164564;259;2021-10-06;104508
2021-10-05;"Košický kraj";345;4265;76;4341;NA;164564;421;2021-10-05;104249
2021-10-04;"Košický kraj";122;5829;107;5936;NA;164564;229;2021-10-04;103828
2021-10-03;"Košický kraj";133;3063;71;3134;NA;164564;204;2021-10-03;103599
2021-10-02;"Košický kraj";124;2225;39;2264;NA;164564;163;2021-10-02;103395
2021-10-01;"Košický kraj";181;3742;70;3812;NA;164564;251;2021-10-01;103232
2021-09-30;"Košický kraj";244;4605;68;4673;NA;164564;312;2021-09-30;102981
2021-09-29;"Košický kraj";183;3824;64;3888;NA;164564;247;2021-09-29;102669
2021-09-28;"Košický kraj";303;4111;76;4187;NA;164564;379;2021-09-28;102422
2021-09-27;"Košický kraj";117;6087;76;6163;NA;164564;193;2021-09-27;102043
2021-09-26;"Košický kraj";13;2618;43;2661;NA;164564;56;2021-09-26;101850
2021-09-25;"Košický kraj";162;2319;34;2353;NA;164564;196;2021-09-25;101794
2021-09-24;"Košický kraj";183;4501;43;4544;NA;164564;226;2021-09-24;101598
2021-09-23;"Košický kraj";142;3662;50;3712;NA;164564;192;2021-09-23;101372
2021-09-22;"Košický kraj";151;4216;50;4266;NA;164564;201;2021-09-22;101180
2021-09-21;"Košický kraj";234;4231;43;4274;NA;164564;277;2021-09-21;100979
2021-09-20;"Košický kraj";158;5753;67;5820;NA;164564;225;2021-09-20;100702
2021-09-19;"Košický kraj";15;2487;30;2517;NA;164564;45;2021-09-19;100477
2021-09-18;"Košický kraj";187;2283;19;2302;NA;164564;206;2021-09-18;100432
2021-09-17;"Košický kraj";121;4566;41;4607;NA;164564;162;2021-09-17;100226
2021-09-16;"Košický kraj";228;4282;67;4349;NA;164564;295;2021-09-16;100064
2021-09-15;"Košický kraj";52;849;16;865;NA;164564;68;2021-09-15;99769
2021-09-14;"Košický kraj";142;3331;47;3378;NA;164564;189;2021-09-14;99701
2021-09-13;"Košický kraj";96;4654;46;4700;NA;164564;142;2021-09-13;99512
2021-09-12;"Košický kraj";14;2003;31;2034;NA;164564;45;2021-09-12;99370
2021-09-11;"Košický kraj";105;2027;17;2044;NA;164564;122;2021-09-11;99325
2021-09-10;"Košický kraj";125;4177;42;4219;NA;164564;167;2021-09-10;99203
2021-09-09;"Košický kraj";115;3093;30;3123;NA;164564;145;2021-09-09;99036
2021-09-08;"Košický kraj";86;2691;36;2727;NA;164564;122;2021-09-08;98891
2021-09-07;"Košický kraj";79;2630;53;2683;NA;164564;132;2021-09-07;98769
2021-09-06;"Košický kraj";41;2717;35;2752;NA;164564;76;2021-09-06;98637
2021-09-05;"Košický kraj";52;1393;18;1411;NA;164564;70;2021-09-05;98561
2021-09-04;"Košický kraj";37;1610;12;1622;NA;164564;49;2021-09-04;98491
2021-09-03;"Košický kraj";47;2825;30;2855;NA;164564;77;2021-09-03;98442
2021-09-02;"Košický kraj";56;2621;24;2645;NA;164564;80;2021-09-02;98365
2021-09-01;"Košický kraj";95;584;11;595;NA;164564;106;2021-09-01;98285
2021-08-31;"Košický kraj";30;2466;22;2488;NA;164564;52;2021-08-31;98179
2021-08-30;"Košický kraj";8;2343;28;2371;NA;164564;36;2021-08-30;98127
2021-08-29;"Košický kraj";16;603;1;604;NA;164564;17;2021-08-29;98091
2021-08-28;"Košický kraj";14;1996;11;2007;NA;164564;25;2021-08-28;98074
2021-08-27;"Košický kraj";22;2818;16;2834;NA;164564;38;2021-08-27;98049
2021-08-26;"Košický kraj";19;2237;13;2250;NA;164564;32;2021-08-26;98011
2021-08-25;"Košický kraj";33;1939;6;1945;NA;164564;39;2021-08-25;97979
2021-08-24;"Košický kraj";14;2272;3;2275;NA;164564;17;2021-08-24;97940
2021-08-23;"Košický kraj";33;2398;5;2403;NA;164564;38;2021-08-23;97923
2021-08-22;"Košický kraj";4;1457;8;1465;NA;164564;12;2021-08-22;97885
2021-08-21;"Košický kraj";35;2042;3;2045;NA;164564;38;2021-08-21;97873
2021-08-20;"Košický kraj";13;3098;5;3103;NA;164564;18;2021-08-20;97835
2021-08-19;"Košický kraj";14;2117;6;2123;NA;164564;20;2021-08-19;97817
2021-08-18;"Košický kraj";30;1770;8;1778;NA;164564;38;2021-08-18;97797
2021-08-17;"Košický kraj";24;1619;3;1622;NA;164564;27;2021-08-17;97759
2021-08-16;"Košický kraj";3;2131;8;2139;NA;164564;11;2021-08-16;97732
2021-08-15;"Košický kraj";1;771;5;776;NA;164564;6;2021-08-15;97721
2021-08-14;"Košický kraj";15;1144;1;1145;NA;164564;16;2021-08-14;97715
2021-08-13;"Košický kraj";14;1857;8;1865;NA;164564;22;2021-08-13;97699
2021-08-12;"Košický kraj";10;1161;3;1164;NA;164564;13;2021-08-12;97677
2021-08-11;"Košický kraj";6;1298;4;1302;NA;164564;10;2021-08-11;97664
2021-08-10;"Košický kraj";10;1352;8;1360;NA;164564;18;2021-08-10;97654
2021-08-09;"Košický kraj";12;1586;2;1588;NA;164564;14;2021-08-09;97636
2021-08-08;"Košický kraj";8;688;1;689;NA;164564;9;2021-08-08;97622
2021-08-07;"Košický kraj";3;1061;3;1064;NA;164564;6;2021-08-07;97613
2021-08-06;"Košický kraj";9;1536;6;1542;NA;164564;15;2021-08-06;97607
2021-08-05;"Košický kraj";26;1220;6;1226;NA;164564;32;2021-08-05;97592
2021-08-04;"Košický kraj";8;1321;4;1325;NA;164564;12;2021-08-04;97560
2021-08-03;"Košický kraj";33;1078;3;1081;NA;164564;36;2021-08-03;97548
2021-08-02;"Košický kraj";6;1613;8;1621;NA;164564;14;2021-08-02;97512
2021-08-01;"Košický kraj";1;662;1;663;NA;164564;2;2021-08-01;97498
2021-07-31;"Košický kraj";17;1072;2;1074;NA;164564;19;2021-07-31;97496
2021-07-30;"Košický kraj";12;1584;7;1591;NA;164564;19;2021-07-30;97477
2021-07-29;"Košický kraj";7;1188;5;1193;NA;164564;12;2021-07-29;97458
2021-07-28;"Košický kraj";15;910;4;914;NA;164564;19;2021-07-28;97446
2021-07-27;"Košický kraj";17;1132;7;1139;NA;164564;24;2021-07-27;97427
2021-07-26;"Košický kraj";3;1585;8;1593;NA;164564;11;2021-07-26;97403
2021-07-25;"Košický kraj";0;719;3;722;NA;164564;3;2021-07-25;97392
2021-07-24;"Košický kraj";18;928;4;932;NA;164564;22;2021-07-24;97389
2021-07-23;"Košický kraj";9;1446;5;1451;NA;164564;14;2021-07-23;97367
2021-07-22;"Košický kraj";1;1177;4;1181;NA;164564;5;2021-07-22;97353
2021-07-21;"Košický kraj";4;1117;3;1120;NA;164564;7;2021-07-21;97348
2021-07-20;"Košický kraj";6;1291;1;1292;NA;164564;7;2021-07-20;97341
2021-07-19;"Košický kraj";2;1449;2;1451;NA;164564;4;2021-07-19;97334
2021-07-18;"Košický kraj";0;643;0;643;NA;164564;0;2021-07-18;97330
2021-07-17;"Košický kraj";3;986;5;991;NA;164564;8;2021-07-17;97330
2021-07-16;"Košický kraj";3;1486;4;1490;NA;164564;7;2021-07-16;97322
2021-07-15;"Košický kraj";4;1295;4;1299;NA;164564;8;2021-07-15;97315
2021-07-14;"Košický kraj";2;1096;3;1099;NA;164564;5;2021-07-14;97307
2021-07-13;"Košický kraj";4;1294;1;1295;NA;164564;5;2021-07-13;97302
2021-07-12;"Košický kraj";3;1808;3;1811;NA;164564;6;2021-07-12;97297
2021-07-11;"Košický kraj";1;537;2;539;NA;164564;3;2021-07-11;97291
2021-07-10;"Košický kraj";9;1051;0;1051;NA;164564;9;2021-07-10;97288
2021-07-09;"Košický kraj";5;1862;5;1867;NA;164564;10;2021-07-09;97279
2021-07-08;"Košický kraj";13;1211;2;1213;NA;164564;15;2021-07-08;97269
2021-07-07;"Košický kraj";6;1436;1;1437;NA;164564;7;2021-07-07;97254
2021-07-06;"Košický kraj";4;1766;2;1768;NA;164564;6;2021-07-06;97247
2021-07-05;"Košický kraj";1;491;0;491;NA;164564;1;2021-07-05;97241
2021-07-04;"Košický kraj";0;480;2;482;NA;164564;2;2021-07-04;97240
2021-07-03;"Košický kraj";2;1112;0;1112;NA;164564;2;2021-07-03;97238
2021-07-02;"Košický kraj";2;1730;3;1733;NA;164564;5;2021-07-02;97236
2021-07-01;"Košický kraj";0;1139;2;1141;NA;164564;2;2021-07-01;97231
2021-06-30;"Košický kraj";5;9306;7;9313;NA;164564;12;2021-06-30;97229
2021-06-29;"Košický kraj";6;5692;7;5699;NA;164564;13;2021-06-29;97217
2021-06-28;"Košický kraj";5;6129;2;6131;NA;164564;7;2021-06-28;97204
2021-06-27;"Košický kraj";8;4612;3;4615;NA;164564;11;2021-06-27;97197
2021-06-26;"Košický kraj";4;5699;14;5713;NA;164564;18;2021-06-26;97186
2021-06-25;"Košický kraj";5;6981;2;6983;NA;164564;7;2021-06-25;97168
2021-06-24;"Košický kraj";1;5072;3;5075;NA;164564;4;2021-06-24;97161
2021-06-23;"Košický kraj";8;5373;3;5376;NA;164564;11;2021-06-23;97157
2021-06-22;"Košický kraj";1;5269;3;5272;NA;164564;4;2021-06-22;97146
2021-06-21;"Košický kraj";5;6830;11;6841;NA;164564;16;2021-06-21;97142
2021-06-20;"Košický kraj";0;4882;6;4888;NA;164564;6;2021-06-20;97126
2021-06-19;"Košický kraj";7;6473;1;6474;NA;164564;8;2021-06-19;97120
2021-06-18;"Košický kraj";4;7969;8;7977;NA;164564;12;2021-06-18;97112
2021-06-17;"Košický kraj";6;6128;3;6131;NA;164564;9;2021-06-17;97100
2021-06-16;"Košický kraj";11;6059;7;6066;NA;164564;18;2021-06-16;97091
2021-06-15;"Košický kraj";12;6301;2;6303;NA;164564;14;2021-06-15;97073
2021-06-14;"Košický kraj";10;7076;9;7085;NA;164564;19;2021-06-14;97059
2021-06-13;"Košický kraj";7;6948;8;6956;NA;164564;15;2021-06-13;97040
2021-06-12;"Košický kraj";7;7485;9;7494;NA;164564;16;2021-06-12;97025
2021-06-11;"Košický kraj";15;8973;6;8979;NA;164564;21;2021-06-11;97009
2021-06-10;"Košický kraj";11;6588;16;6604;NA;164564;27;2021-06-10;96988
2021-06-09;"Košický kraj";37;6056;7;6063;NA;164564;44;2021-06-09;96961
2021-06-08;"Košický kraj";33;7019;13;7032;NA;164564;46;2021-06-08;96917
2021-06-07;"Košický kraj";11;8106;22;8128;NA;164564;33;2021-06-07;96871
2021-06-06;"Košický kraj";1;7843;7;7850;NA;164564;8;2021-06-06;96838
2021-06-05;"Košický kraj";21;9286;3;9289;NA;164564;24;2021-06-05;96830
2021-06-04;"Košický kraj";26;11418;20;11438;NA;164564;46;2021-06-04;96806
2021-06-03;"Košický kraj";23;6467;14;6481;NA;164564;37;2021-06-03;96760
2021-06-02;"Košický kraj";15;7180;24;7204;NA;164564;39;2021-06-02;96723
2021-06-01;"Košický kraj";13;7562;10;7572;NA;164564;23;2021-06-01;96684
2021-05-31;"Košický kraj";13;9256;18;9274;NA;164564;31;2021-05-31;96661
2021-05-30;"Košický kraj";3;11215;10;11225;NA;164564;13;2021-05-30;96630
2021-05-29;"Košický kraj";25;10942;22;10964;NA;164564;47;2021-05-29;96617
2021-05-28;"Košický kraj";17;13055;29;13084;NA;164564;46;2021-05-28;96570
2021-05-27;"Košický kraj";19;7924;26;7950;NA;164564;45;2021-05-27;96524
2021-05-26;"Košický kraj";35;8118;27;8145;NA;164564;62;2021-05-26;96479
2021-05-25;"Košický kraj";33;9296;29;9325;NA;164564;62;2021-05-25;96417
2021-05-24;"Košický kraj";10;10855;27;10882;NA;164564;37;2021-05-24;96355
2021-05-23;"Košický kraj";4;12151;15;12166;NA;164564;19;2021-05-23;96318
2021-05-22;"Košický kraj";27;12601;19;12620;NA;164564;46;2021-05-22;96299
2021-05-21;"Košický kraj";24;14910;27;14937;NA;164564;51;2021-05-21;96253
2021-05-20;"Košický kraj";20;9422;28;9450;NA;164564;48;2021-05-20;96202
2021-05-19;"Košický kraj";30;10421;21;10442;NA;164564;51;2021-05-19;96154
2021-05-18;"Košický kraj";34;10254;36;10290;NA;164564;70;2021-05-18;96103
2021-05-17;"Košický kraj";20;12686;38;12724;NA;164564;58;2021-05-17;96033
2021-05-16;"Košický kraj";37;17865;20;17885;NA;164564;57;2021-05-16;95975
2021-05-15;"Košický kraj";22;25602;28;25630;NA;164564;50;2021-05-15;95918
2021-05-14;"Košický kraj";32;21824;42;21866;NA;164564;74;2021-05-14;95868
2021-05-13;"Košický kraj";39;10172;32;10204;NA;164564;71;2021-05-13;95794
2021-05-12;"Košický kraj";85;10868;33;10901;NA;164564;118;2021-05-12;95723
2021-05-11;"Košický kraj";68;11166;32;11198;NA;164564;100;2021-05-11;95605
2021-05-10;"Košický kraj";25;17044;42;17086;NA;164564;67;2021-05-10;95505
2021-05-09;"Košický kraj";84;25594;55;25649;NA;164564;139;2021-05-09;95438
2021-05-08;"Košický kraj";18;23399;23;23422;NA;164564;41;2021-05-08;95299
2021-05-07;"Košický kraj";51;24497;57;24554;NA;164564;108;2021-05-07;95258
2021-05-06;"Košický kraj";55;11847;43;11890;NA;164564;98;2021-05-06;95150
2021-05-05;"Košický kraj";23;12124;35;12159;NA;164564;58;2021-05-05;95052
2021-05-04;"Košický kraj";143;13562;38;13600;NA;164564;181;2021-05-04;94994
2021-05-03;"Košický kraj";37;16944;68;17012;NA;164564;105;2021-05-03;94813
2021-05-02;"Košický kraj";45;36096;56;36152;NA;164564;101;2021-05-02;94708
2021-05-01;"Košický kraj";54;52075;76;52151;NA;164564;130;2021-05-01;94607
2021-04-30;"Košický kraj";59;44602;94;44696;NA;164564;153;2021-04-30;94477
2021-04-29;"Košický kraj";76;17014;53;17067;NA;164564;129;2021-04-29;94324
2021-04-28;"Košický kraj";99;17970;52;18022;NA;164564;151;2021-04-28;94195
2021-04-27;"Košický kraj";108;20670;43;20713;NA;164564;151;2021-04-27;94044
2021-04-26;"Košický kraj";39;25915;96;26011;NA;164564;135;2021-04-26;93893
2021-04-25;"Košický kraj";23;48355;57;48412;NA;164564;80;2021-04-25;93758
2021-04-24;"Košický kraj";68;90124;114;90238;NA;164564;182;2021-04-24;93678
2021-04-23;"Košický kraj";110;41232;72;41304;NA;164564;182;2021-04-23;93496
2021-04-22;"Košický kraj";56;16772;44;16816;NA;164564;100;2021-04-22;93314
2021-04-21;"Košický kraj";114;19519;61;19580;NA;164564;175;2021-04-21;93214
2021-04-20;"Košický kraj";81;25432;63;25495;NA;164564;144;2021-04-20;93039
2021-04-19;"Košický kraj";93;29950;108;30058;NA;164564;201;2021-04-19;92895
2021-04-18;"Košický kraj";10;48913;82;48995;NA;164564;92;2021-04-18;92694
2021-04-17;"Košický kraj";187;83856;103;83959;NA;164564;290;2021-04-17;92602
2021-04-16;"Košický kraj";83;41568;127;41695;NA;164564;210;2021-04-16;92312
2021-04-15;"Košický kraj";104;18522;93;18615;NA;164564;197;2021-04-15;92102
2021-04-14;"Košický kraj";119;20089;64;20153;NA;164564;183;2021-04-14;91905
2021-04-13;"Košický kraj";81;23175;120;23295;NA;164564;201;2021-04-13;91722
2021-04-12;"Košický kraj";129;26573;124;26697;NA;164564;253;2021-04-12;91521
2021-04-11;"Košický kraj";29;46949;80;47029;NA;164564;109;2021-04-11;91268
2021-04-10;"Košický kraj";138;100114;183;100297;NA;164564;321;2021-04-10;91159
2021-04-09;"Košický kraj";168;35206;133;35339;NA;164564;301;2021-04-09;90838
2021-04-08;"Košický kraj";81;18530;90;18620;NA;164564;171;2021-04-08;90537
2021-04-07;"Košický kraj";232;28027;194;28221;NA;164564;426;2021-04-07;90366
2021-04-06;"Košický kraj";121;36495;164;36659;NA;164564;285;2021-04-06;89940
2021-04-05;"Košický kraj";19;14361;66;14427;NA;164564;85;2021-04-05;89655
2021-04-04;"Košický kraj";33;15089;66;15155;NA;164564;99;2021-04-04;89570
2021-04-03;"Košický kraj";138;97664;241;97905;NA;164564;379;2021-04-03;89471
2021-04-02;"Košický kraj";128;24515;76;24591;NA;164564;204;2021-04-02;89092
2021-04-01;"Košický kraj";165;46151;156;46307;NA;164564;321;2021-04-01;88888
2021-03-31;"Košický kraj";160;29659;124;29783;NA;164564;284;2021-03-31;88567
2021-03-30;"Košický kraj";229;24038;163;24201;NA;164564;392;2021-03-30;88283
2021-03-29;"Košický kraj";78;28843;194;29037;NA;164564;272;2021-03-29;87891
2021-03-28;"Košický kraj";39;44263;128;44391;NA;164564;167;2021-03-28;87619
2021-03-27;"Košický kraj";222;96602;265;96867;NA;164564;487;2021-03-27;87452
2021-03-26;"Košický kraj";233;45252;202;45454;NA;164564;435;2021-03-26;86965
2021-03-25;"Košický kraj";133;23804;175;23979;NA;164564;308;2021-03-25;86530
2021-03-24;"Košický kraj";165;20696;155;20851;NA;164564;320;2021-03-24;86222
2021-03-23;"Košický kraj";202;22434;192;22626;NA;164564;394;2021-03-23;85902
2021-03-22;"Košický kraj";169;26890;228;27118;NA;164564;397;2021-03-22;85508
2021-03-21;"Košický kraj";109;46746;167;46913;NA;164564;276;2021-03-21;85111
2021-03-20;"Košický kraj";126;101334;311;101645;NA;164564;437;2021-03-20;84835
2021-03-19;"Košický kraj";205;45632;260;45892;NA;164564;465;2021-03-19;84398
2021-03-18;"Košický kraj";274;23827;212;24039;NA;164564;486;2021-03-18;83933
2021-03-17;"Košický kraj";177;21548;195;21743;NA;164564;372;2021-03-17;83447
2021-03-16;"Košický kraj";386;23454;226;23680;NA;164564;612;2021-03-16;83075
2021-03-15;"Košický kraj";173;27900;297;28197;NA;164564;470;2021-03-15;82463
2021-03-14;"Košický kraj";145;44354;220;44574;NA;164564;365;2021-03-14;81993
2021-03-13;"Košický kraj";146;103790;483;104273;NA;164564;629;2021-03-13;81628
2021-03-12;"Košický kraj";366;47871;321;48192;NA;164564;687;2021-03-12;80999
2021-03-11;"Košický kraj";396;23229;263;23492;NA;164564;659;2021-03-11;80312
2021-03-10;"Košický kraj";121;22205;269;22474;NA;164564;390;2021-03-10;79653
2021-03-09;"Košický kraj";676;24509;300;24809;NA;164564;976;2021-03-09;79263
2021-03-08;"Košický kraj";559;29852;344;30196;NA;164564;903;2021-03-08;78287
2021-03-07;"Košický kraj";45;44230;299;44529;NA;164564;344;2021-03-07;77384
2021-03-06;"Košický kraj";177;105598;532;106130;NA;164564;709;2021-03-06;77040
2021-03-05;"Košický kraj";439;45567;424;45991;NA;164564;863;2021-03-05;76331
2021-03-04;"Košický kraj";417;23862;320;24182;NA;164564;737;2021-03-04;75468
2021-03-03;"Košický kraj";390;23169;298;23467;NA;164564;688;2021-03-03;74731
2021-03-02;"Košický kraj";464;24158;368;24526;NA;164564;832;2021-03-02;74043
2021-03-01;"Košický kraj";389;30013;514;30527;NA;164564;903;2021-03-01;73211
2021-02-28;"Košický kraj";265;43053;334;43387;NA;164564;599;2021-02-28;72308
2021-02-27;"Košický kraj";301;100559;784;101343;NA;164564;1085;2021-02-27;71709
2021-02-26;"Košický kraj";440;45466;492;45958;NA;164564;932;2021-02-26;70624
2021-02-25;"Košický kraj";331;19872;342;20214;NA;164564;673;2021-02-25;69692
2021-02-24;"Košický kraj";263;18751;505;19256;NA;164564;768;2021-02-24;69019
2021-02-23;"Košický kraj";642;21605;341;21946;NA;164564;983;2021-02-23;68251
2021-02-22;"Košický kraj";362;30858;434;31292;NA;164564;796;2021-02-22;67268
2021-02-21;"Košický kraj";170;40464;385;40849;NA;164564;555;2021-02-21;66472
2021-02-20;"Košický kraj";283;92550;770;93320;NA;164564;1053;2021-02-20;65917
2021-02-19;"Košický kraj";507;41579;583;42162;NA;164564;1090;2021-02-19;64864
2021-02-18;"Košický kraj";397;18442;345;18787;NA;164564;742;2021-02-18;63774
2021-02-17;"Košický kraj";322;18080;387;18467;NA;164564;709;2021-02-17;63032
2021-02-16;"Košický kraj";600;22111;463;22574;NA;164564;1063;2021-02-16;62323
2021-02-15;"Košický kraj";216;27633;419;28052;NA;164564;635;2021-02-15;61260
2021-02-14;"Košický kraj";241;56743;524;57267;NA;164564;765;2021-02-14;60625
2021-02-13;"Košický kraj";206;93745;765;94510;NA;164564;971;2021-02-13;59860
2021-02-12;"Košický kraj";448;49924;611;50535;NA;164564;1059;2021-02-12;58889
2021-02-11;"Košický kraj";435;14524;323;14847;NA;164564;758;2021-02-11;57830
2021-02-10;"Košický kraj";360;18475;431;18906;NA;164564;791;2021-02-10;57072
2021-02-09;"Košický kraj";544;24841;463;25304;NA;164564;1007;2021-02-09;56281
2021-02-08;"Košický kraj";237;24836;392;25228;NA;164564;629;2021-02-08;55274
2021-02-07;"Košický kraj";208;56897;612;57509;NA;164564;820;2021-02-07;54645
2021-02-06;"Košický kraj";318;104357;884;105241;NA;164564;1202;2021-02-06;53825
2021-02-05;"Košický kraj";384;43186;494;43680;NA;164564;878;2021-02-05;52623
2021-02-04;"Košický kraj";391;14512;371;14883;NA;164564;762;2021-02-04;51745
2021-02-03;"Košický kraj";296;12599;339;12938;NA;164564;635;2021-02-03;50983
2021-02-02;"Košický kraj";473;43883;1212;45095;NA;164564;1685;2021-02-02;50348
2021-02-01;"Košický kraj";415;21984;362;22346;NA;164564;777;2021-02-01;48663
2021-01-31;"Košický kraj";142;54690;617;55307;NA;164564;759;2021-01-31;47886
2021-01-30;"Košický kraj";320;76722;661;77383;NA;164564;981;2021-01-30;47127
2021-01-29;"Košický kraj";311;37164;466;37630;NA;164564;777;2021-01-29;46146
2021-01-28;"Košický kraj";540;9006;244;9250;NA;164564;784;2021-01-28;45369
2021-01-27;"Košický kraj";265;7575;211;7786;NA;164564;476;2021-01-27;44585
2021-01-26;"Košický kraj";530;14210;245;14455;NA;164564;775;2021-01-26;44109
2021-01-25;"Košický kraj";226;26431;413;26844;NA;164564;639;2021-01-25;43334
2021-01-24;"Košický kraj";150;44419;581;45000;NA;164564;731;2021-01-24;42695
2021-01-23;"Košický kraj";232;82705;857;83562;NA;164564;1089;2021-01-23;41964
2021-01-22;"Košický kraj";316;19997;265;20262;NA;164564;581;2021-01-22;40875
2021-01-21;"Košický kraj";274;14053;159;14212;NA;164564;433;2021-01-21;40294
2021-01-20;"Košický kraj";374;10844;201;11045;NA;164564;575;2021-01-20;39861
2021-01-19;"Košický kraj";248;9717;181;9898;NA;164564;429;2021-01-19;39286
2021-01-18;"Košický kraj";333;7659;262;7921;NA;164564;595;2021-01-18;38857
2021-01-17;"Košický kraj";155;535;14;549;NA;164564;169;2021-01-17;38262
2021-01-16;"Košický kraj";153;1403;47;1450;NA;164564;200;2021-01-16;38093
2021-01-15;"Košický kraj";308;6443;213;6656;NA;164564;521;2021-01-15;37893
2021-01-14;"Košický kraj";358;5471;221;5692;NA;164564;579;2021-01-14;37372
2021-01-13;"Košický kraj";421;4897;226;5123;NA;164564;647;2021-01-13;36793
2021-01-12;"Košický kraj";482;6473;237;6710;NA;164564;719;2021-01-12;36146
2021-01-11;"Košický kraj";309;7553;286;7839;NA;164564;595;2021-01-11;35427
2021-01-10;"Košický kraj";193;136;6;142;NA;164564;199;2021-01-10;34832
2021-01-09;"Košický kraj";469;1134;45;1179;NA;164564;514;2021-01-09;34633
2021-01-08;"Košický kraj";551;7106;348;7454;NA;164564;899;2021-01-08;34119
2021-01-07;"Košický kraj";251;5853;398;6251;NA;164564;649;2021-01-07;33220
2021-01-06;"Košický kraj";442;429;33;462;NA;164564;475;2021-01-06;32571
2021-01-05;"Košický kraj";584;7633;527;8160;NA;164564;1111;2021-01-05;32096
2021-01-04;"Košický kraj";407;6479;660;7139;NA;164564;1067;2021-01-04;30985
2021-01-03;"Košický kraj";118;661;22;683;NA;164564;140;2021-01-03;29918
2021-01-02;"Košický kraj";88;440;52;492;NA;164564;140;2021-01-02;29778
2021-01-01;"Košický kraj";398;725;49;774;NA;164564;447;2021-01-01;29638
2020-12-31;"Košický kraj";625;7509;453;7962;NA;164564;1078;2020-12-31;29191
2020-12-30;"Košický kraj";590;6076;395;6471;NA;164564;985;2020-12-30;28113
2020-12-29;"Košický kraj";419;7454;596;8050;NA;164564;1015;2020-12-29;27128
2020-12-28;"Košický kraj";356;7933;756;8689;NA;164564;1112;2020-12-28;26113
2020-12-27;"Košický kraj";159;147;16;163;NA;164564;175;2020-12-27;25001
2020-12-26;"Košický kraj";163;274;23;297;NA;164564;186;2020-12-26;24826
2020-12-25;"Košický kraj";237;140;10;150;NA;164564;247;2020-12-25;24640
2020-12-24;"Košický kraj";564;1470;90;1560;NA;164564;654;2020-12-24;24393
2020-12-23;"Košický kraj";304;7339;327;7666;NA;164564;631;2020-12-23;23739
2020-12-22;"Košický kraj";438;7284;429;7713;NA;164564;867;2020-12-22;23108
2020-12-21;"Košický kraj";405;6703;504;7207;NA;164564;909;2020-12-21;22241
2020-12-20;"Košický kraj";215;73;11;84;NA;164564;226;2020-12-20;21332
2020-12-19;"Košický kraj";207;1309;63;1372;NA;164564;270;2020-12-19;21106
2020-12-18;"Košický kraj";310;7707;292;7999;NA;164564;602;2020-12-18;20836
2020-12-17;"Košický kraj";463;5101;253;5354;NA;164564;716;2020-12-17;20234
2020-12-16;"Košický kraj";455;5725;295;6020;NA;164564;750;2020-12-16;19518
2020-12-15;"Košický kraj";319;4787;327;5114;NA;164564;646;2020-12-15;18768
2020-12-14;"Košický kraj";256;2905;225;3130;NA;164564;481;2020-12-14;18122
2020-12-13;"Košický kraj";47;181;2;183;NA;164564;49;2020-12-13;17641
2020-12-12;"Košický kraj";369;1587;118;1705;NA;164564;487;2020-12-12;17592
2020-12-11;"Košický kraj";354;5328;256;5584;NA;164564;610;2020-12-11;17105
2020-12-10;"Košický kraj";283;3987;174;4161;NA;164564;457;2020-12-10;16495
2020-12-09;"Košický kraj";279;3786;166;3952;NA;164564;445;2020-12-09;16038
2020-12-08;"Košický kraj";226;4105;355;4460;NA;164564;581;2020-12-08;15593
2020-12-07;"Košický kraj";270;2383;106;2489;NA;164564;376;2020-12-07;15012
2020-12-06;"Košický kraj";121;97;20;117;NA;164564;141;2020-12-06;14636
2020-12-05;"Košický kraj";90;1096;48;1144;NA;164564;138;2020-12-05;14495
2020-12-04;"Košický kraj";224;2680;82;2762;NA;164564;306;2020-12-04;14357
2020-12-03;"Košický kraj";211;7717;173;7890;NA;164564;384;2020-12-03;14051
2020-12-02;"Košický kraj";193;8132;496;8628;NA;164564;689;2020-12-02;13667
2020-12-01;"Košický kraj";178;2237;124;2361;NA;164564;302;2020-12-01;12978
2020-11-30;"Košický kraj";171;3598;59;3657;NA;164564;230;2020-11-30;12676
2020-11-29;"Košický kraj";31;325;17;342;NA;164564;48;2020-11-29;12446
2020-11-28;"Košický kraj";69;721;52;773;NA;164564;121;2020-11-28;12398
2020-11-27;"Košický kraj";149;2921;78;2999;NA;164564;227;2020-11-27;12277
2020-11-26;"Košický kraj";239;1234;60;1294;NA;164564;299;2020-11-26;12050
2020-11-25;"Košický kraj";237;1785;123;1908;NA;164564;360;2020-11-25;11751
2020-11-24;"Košický kraj";196;1976;67;2043;NA;164564;263;2020-11-24;11391
2020-11-23;"Košický kraj";51;4115;63;4178;NA;164564;114;2020-11-23;11128
2020-11-22;"Košický kraj";57;57;5;62;NA;164564;62;2020-11-22;11014
2020-11-21;"Košický kraj";87;858;36;894;NA;164564;123;2020-11-21;10952
2020-11-20;"Košický kraj";176;3084;49;3133;NA;164564;225;2020-11-20;10829
2020-11-19;"Košický kraj";206;1736;48;1784;NA;164564;254;2020-11-19;10604
2020-11-18;"Košický kraj";122;532;17;549;NA;164564;139;2020-11-18;10350
2020-11-17;"Košický kraj";152;82;9;91;NA;164564;161;2020-11-17;10211
2020-11-16;"Košický kraj";114;596;27;623;NA;164564;141;2020-11-16;10050
2020-11-15;"Košický kraj";15;338;7;345;NA;164564;22;2020-11-15;9909
2020-11-14;"Košický kraj";234;520;12;532;NA;164564;246;2020-11-14;9887
2020-11-13;"Košický kraj";207;664;29;693;NA;164564;236;2020-11-13;9641
2020-11-12;"Košický kraj";192;736;13;749;NA;164564;205;2020-11-12;9405
2020-11-11;"Košický kraj";301;593;7;600;NA;164564;308;2020-11-11;9200
2020-11-10;"Košický kraj";190;541;11;552;NA;164564;201;2020-11-10;8892
2020-11-09;"Košický kraj";129;380;17;397;NA;164564;146;2020-11-09;8691
2020-11-08;"Košický kraj";78;1306;8;1314;NA;164564;86;2020-11-08;8545
2020-11-07;"Košický kraj";192;3909;22;3931;NA;164564;214;2020-11-07;8459
2020-11-06;"Košický kraj";195;5310;34;5344;NA;164564;229;2020-11-06;8245
2020-11-05;"Košický kraj";342;330;31;361;NA;164564;373;2020-11-05;8016
2020-11-04;"Košický kraj";101;154;6;160;NA;164564;107;2020-11-04;7643
2020-11-03;"Košický kraj";358;1122;13;1135;NA;164564;371;2020-11-03;7536
2020-11-02;"Košický kraj";111;6125;56;6181;NA;164564;167;2020-11-02;7165
2020-11-01;"Košický kraj";346;6522;34;6556;NA;164564;380;2020-11-01;6998
2020-10-31;"Košický kraj";82;14035;106;14141;NA;164564;188;2020-10-31;6618
2020-10-30;"Košický kraj";379;2835;27;2862;NA;164564;406;2020-10-30;6430
2020-10-29;"Košický kraj";333;983;13;996;NA;164564;346;2020-10-29;6024
2020-10-28;"Košický kraj";224;305;13;318;NA;164564;237;2020-10-28;5678
2020-10-27;"Košický kraj";386;439;21;460;NA;164564;407;2020-10-27;5441
2020-10-26;"Košický kraj";56;212;12;224;NA;164564;68;2020-10-26;5034
2020-10-25;"Košický kraj";154;79;2;81;NA;164564;156;2020-10-25;4966
2020-10-24;"Košický kraj";313;118;16;134;NA;164564;329;2020-10-24;4810
2020-10-23;"Košický kraj";315;331;8;339;NA;164564;323;2020-10-23;4481
2020-10-22;"Košický kraj";349;530;16;546;NA;164564;365;2020-10-22;4158
2020-10-21;"Košický kraj";129;84;2;86;NA;164564;131;2020-10-21;3793
2020-10-20;"Košický kraj";181;14;1;15;NA;164564;182;2020-10-20;3662
2020-10-19;"Košický kraj";64;38;1;39;NA;164564;65;2020-10-19;3480
2020-10-18;"Košický kraj";158;0;0;0;NA;164564;158;2020-10-18;3415
2020-10-17;"Košický kraj";142;0;0;0;NA;164564;142;2020-10-17;3257
2020-10-16;"Košický kraj";206;19;0;19;NA;164564;206;2020-10-16;3115
2020-10-15;"Košický kraj";177;19;5;24;NA;164564;182;2020-10-15;2909
2020-10-14;"Košický kraj";211;8;0;8;NA;164564;211;2020-10-14;2727
2020-10-13;"Košický kraj";179;80;3;83;NA;164564;182;2020-10-13;2516
2020-10-12;"Košický kraj";74;0;0;0;NA;164564;74;2020-10-12;2334
2020-10-11;"Košický kraj";121;0;0;0;NA;164564;121;2020-10-11;2260
2020-10-10;"Košický kraj";70;0;0;0;NA;164564;70;2020-10-10;2139
2020-10-09;"Košický kraj";188;0;0;0;NA;164564;188;2020-10-09;2069
2020-10-08;"Košický kraj";102;0;0;0;NA;164564;102;2020-10-08;1881
2020-10-07;"Košický kraj";158;0;0;0;NA;164564;158;2020-10-07;1779
2020-10-06;"Košický kraj";70;0;0;0;NA;164564;70;2020-10-06;1621
2020-10-05;"Košický kraj";39;0;0;0;NA;164564;39;2020-10-05;1551
2020-10-04;"Košický kraj";45;0;0;0;NA;164564;45;2020-10-04;1512
2020-10-03;"Košický kraj";105;0;0;0;NA;164564;105;2020-10-03;1467
2020-10-02;"Košický kraj";57;0;0;0;NA;164564;57;2020-10-02;1362
2020-10-01;"Košický kraj";69;0;0;0;NA;164564;69;2020-10-01;1305
2020-09-30;"Košický kraj";95;0;0;0;NA;164564;95;2020-09-30;1236
2020-09-29;"Košický kraj";75;0;0;0;NA;164564;75;2020-09-29;1141
2020-09-28;"Košický kraj";19;0;0;0;NA;164564;19;2020-09-28;1066
2020-09-27;"Košický kraj";21;0;0;0;NA;164564;21;2020-09-27;1047
2020-09-26;"Košický kraj";53;0;0;0;NA;164564;53;2020-09-26;1026
2020-09-25;"Košický kraj";72;0;0;0;NA;164564;72;2020-09-25;973
2020-09-24;"Košický kraj";35;0;0;0;NA;164564;35;2020-09-24;901
2020-09-23;"Košický kraj";23;0;0;0;NA;164564;23;2020-09-23;866
2020-09-22;"Košický kraj";39;0;0;0;NA;164564;39;2020-09-22;843
2020-09-21;"Košický kraj";5;0;0;0;NA;164564;5;2020-09-21;804
2020-09-20;"Košický kraj";3;0;0;0;NA;164564;3;2020-09-20;799
2020-09-19;"Košický kraj";13;0;0;0;NA;164564;13;2020-09-19;796
2020-09-18;"Košický kraj";20;0;0;0;NA;164564;20;2020-09-18;783
2020-09-17;"Košický kraj";22;0;0;0;NA;164564;22;2020-09-17;763
2020-09-16;"Košický kraj";12;0;0;0;NA;164564;12;2020-09-16;741
2020-09-15;"Košický kraj";10;0;0;0;NA;164564;10;2020-09-15;729
2020-09-14;"Košický kraj";6;0;0;0;NA;164564;6;2020-09-14;719
2020-09-13;"Košický kraj";3;0;0;0;NA;164564;3;2020-09-13;713
2020-09-12;"Košický kraj";16;0;0;0;NA;164564;16;2020-09-12;710
2020-09-11;"Košický kraj";20;0;0;0;NA;164564;20;2020-09-11;694
2020-09-10;"Košický kraj";11;0;0;0;NA;164564;11;2020-09-10;674
2020-09-09;"Košický kraj";37;0;0;0;NA;164564;37;2020-09-09;663
2020-09-08;"Košický kraj";10;0;0;0;NA;164564;10;2020-09-08;626
2020-09-07;"Košický kraj";4;0;0;0;NA;164564;4;2020-09-07;616
2020-09-06;"Košický kraj";2;0;0;0;NA;164564;2;2020-09-06;612
2020-09-05;"Košický kraj";10;0;0;0;NA;164564;10;2020-09-05;610
2020-09-04;"Košický kraj";14;0;0;0;NA;164564;14;2020-09-04;600
2020-09-03;"Košický kraj";22;0;0;0;NA;164564;22;2020-09-03;586
2020-09-02;"Košický kraj";13;0;0;0;NA;164564;13;2020-09-02;564
2020-09-01;"Košický kraj";21;0;0;0;NA;164564;21;2020-09-01;551
2020-08-31;"Košický kraj";9;0;0;0;NA;164564;9;2020-08-31;530
2020-08-30;"Košický kraj";21;0;0;0;NA;164564;21;2020-08-30;521
2020-08-29;"Košický kraj";1;0;0;0;NA;164564;1;2020-08-29;500
2020-08-28;"Košický kraj";19;0;0;0;NA;164564;19;2020-08-28;499
2020-08-27;"Košický kraj";15;0;0;0;NA;164564;15;2020-08-27;480
2020-08-26;"Košický kraj";8;0;0;0;NA;164564;8;2020-08-26;465
2020-08-25;"Košický kraj";23;0;0;0;NA;164564;23;2020-08-25;457
2020-08-24;"Košický kraj";6;0;0;0;NA;164564;6;2020-08-24;434
2020-08-23;"Košický kraj";8;0;0;0;NA;164564;8;2020-08-23;428
2020-08-22;"Košický kraj";13;0;0;0;NA;164564;13;2020-08-22;420
2020-08-21;"Košický kraj";10;0;0;0;NA;164564;10;2020-08-21;407
2020-08-20;"Košický kraj";10;0;0;0;NA;164564;10;2020-08-20;397
2020-08-19;"Košický kraj";3;0;0;0;NA;164564;3;2020-08-19;387
2020-08-18;"Košický kraj";7;0;0;0;NA;164564;7;2020-08-18;384
2020-08-17;"Košický kraj";2;0;0;0;NA;164564;2;2020-08-17;377
2020-08-16;"Košický kraj";2;0;0;0;NA;164564;2;2020-08-16;375
2020-08-15;"Košický kraj";3;0;0;0;NA;164564;3;2020-08-15;373
2020-08-14;"Košický kraj";1;0;0;0;NA;164564;1;2020-08-14;370
2020-08-13;"Košický kraj";3;0;0;0;NA;164564;3;2020-08-13;369
2020-08-12;"Košický kraj";12;0;0;0;NA;164564;12;2020-08-12;366
2020-08-11;"Košický kraj";5;0;0;0;NA;164564;5;2020-08-11;354
2020-08-10;"Košický kraj";1;0;0;0;NA;164564;1;2020-08-10;349
2020-08-09;"Košický kraj";0;0;0;0;NA;164564;0;2020-08-09;348
2020-08-08;"Košický kraj";5;0;0;0;NA;164564;5;2020-08-08;348
2020-08-07;"Košický kraj";7;0;0;0;NA;164564;7;2020-08-07;343
2020-08-06;"Košický kraj";3;0;0;0;NA;164564;3;2020-08-06;336
2020-08-05;"Košický kraj";4;0;0;0;NA;164564;4;2020-08-05;333
2020-08-04;"Košický kraj";1;0;0;0;NA;164564;1;2020-08-04;329
2020-08-03;"Košický kraj";1;0;0;0;NA;164564;1;2020-08-03;328
2020-08-02;"Košický kraj";0;0;0;0;NA;164564;0;2020-08-02;327
2020-08-01;"Košický kraj";0;0;0;0;NA;164564;0;2020-08-01;327
2020-07-31;"Košický kraj";0;0;0;0;NA;164564;0;2020-07-31;327
2020-07-30;"Košický kraj";2;0;0;0;NA;164564;2;2020-07-30;327
2020-07-29;"Košický kraj";1;0;0;0;NA;164564;1;2020-07-29;325
2020-07-28;"Košický kraj";9;0;0;0;NA;164564;9;2020-07-28;324
2020-07-27;"Košický kraj";4;0;0;0;NA;164564;4;2020-07-27;315
2020-07-26;"Košický kraj";0;0;0;0;NA;164564;0;2020-07-26;311
2020-07-25;"Košický kraj";2;0;0;0;NA;164564;2;2020-07-25;311
2020-07-24;"Košický kraj";2;0;0;0;NA;164564;2;2020-07-24;309
2020-07-23;"Košický kraj";1;0;0;0;NA;164564;1;2020-07-23;307
2020-07-22;"Košický kraj";1;0;0;0;NA;164564;1;2020-07-22;306
2020-07-21;"Košický kraj";0;0;0;0;NA;164564;0;2020-07-21;305
2020-07-20;"Košický kraj";0;0;0;0;NA;164564;0;2020-07-20;305
2020-07-19;"Košický kraj";0;0;0;0;NA;164564;0;2020-07-19;305
2020-07-18;"Košický kraj";1;0;0;0;NA;164564;1;2020-07-18;305
2020-07-17;"Košický kraj";1;0;0;0;NA;164564;1;2020-07-17;304
2020-07-16;"Košický kraj";0;0;0;0;NA;164564;0;2020-07-16;303
2020-07-15;"Košický kraj";2;0;0;0;NA;164564;2;2020-07-15;303
2020-07-14;"Košický kraj";1;0;0;0;NA;164564;1;2020-07-14;301
2020-07-13;"Košický kraj";1;0;0;0;NA;164564;1;2020-07-13;300
2020-07-12;"Košický kraj";0;0;0;0;NA;164564;0;2020-07-12;299
2020-07-11;"Košický kraj";0;0;0;0;NA;164564;0;2020-07-11;299
2020-07-10;"Košický kraj";1;0;0;0;NA;164564;1;2020-07-10;299
2020-07-09;"Košický kraj";1;0;0;0;NA;164564;1;2020-07-09;298
2020-07-08;"Košický kraj";12;0;0;0;NA;164564;12;2020-07-08;297
2020-07-07;"Košický kraj";0;0;0;0;NA;164564;0;2020-07-07;285
2020-07-06;"Košický kraj";0;0;0;0;NA;164564;0;2020-07-06;285
2020-07-05;"Košický kraj";0;0;0;0;NA;164564;0;2020-07-05;285
2020-07-04;"Košický kraj";0;0;0;0;NA;164564;0;2020-07-04;285
2020-07-03;"Košický kraj";1;0;0;0;NA;164564;1;2020-07-03;285
2020-07-02;"Košický kraj";0;0;0;0;NA;164564;0;2020-07-02;284
2020-07-01;"Košický kraj";1;0;0;0;NA;164564;1;2020-07-01;284
2020-06-30;"Košický kraj";0;0;0;0;NA;164564;0;2020-06-30;283
2020-06-29;"Košický kraj";0;0;0;0;NA;164564;0;2020-06-29;283
2020-06-28;"Košický kraj";0;0;0;0;NA;164564;0;2020-06-28;283
2020-06-27;"Košický kraj";0;0;0;0;NA;164564;0;2020-06-27;283
2020-06-26;"Košický kraj";0;0;0;0;NA;164564;0;2020-06-26;283
2020-06-25;"Košický kraj";3;0;0;0;NA;164564;3;2020-06-25;283
2020-06-24;"Košický kraj";3;0;0;0;NA;164564;3;2020-06-24;280
2020-06-23;"Košický kraj";3;0;0;0;NA;164564;3;2020-06-23;277
2020-06-22;"Košický kraj";0;0;0;0;NA;164564;0;2020-06-22;274
2020-06-21;"Košický kraj";0;0;0;0;NA;164564;0;2020-06-21;274
2020-06-20;"Košický kraj";0;0;0;0;NA;164564;0;2020-06-20;274
2020-06-19;"Košický kraj";0;0;0;0;NA;164564;0;2020-06-19;274
2020-06-18;"Košický kraj";1;0;0;0;NA;164564;1;2020-06-18;274
2020-06-17;"Košický kraj";0;0;0;0;NA;164564;0;2020-06-17;273
2020-06-16;"Košický kraj";2;0;0;0;NA;164564;2;2020-06-16;273
2020-06-14;"Košický kraj";0;0;0;0;NA;164564;0;2020-06-14;271
2020-06-13;"Košický kraj";0;0;0;0;NA;164564;0;2020-06-13;271
2020-06-12;"Košický kraj";0;0;0;0;NA;164564;0;2020-06-12;271
2020-06-11;"Košický kraj";0;0;0;0;NA;164564;0;2020-06-11;271
2020-06-10;"Košický kraj";6;0;0;0;NA;164564;6;2020-06-10;271
2020-06-09;"Košický kraj";0;0;0;0;NA;164564;0;2020-06-09;265
2020-06-08;"Košický kraj";0;0;0;0;NA;164564;0;2020-06-08;265
2020-06-07;"Košický kraj";2;0;0;0;NA;164564;2;2020-06-07;265
2020-06-05;"Košický kraj";0;0;0;0;NA;164564;0;2020-06-05;263
2020-06-03;"Košický kraj";0;0;0;0;NA;164564;0;2020-06-03;263
2020-06-02;"Košický kraj";1;0;0;0;NA;164564;1;2020-06-02;263
2020-05-31;"Košický kraj";0;0;0;0;NA;164564;0;2020-05-31;262
2020-05-29;"Košický kraj";1;0;0;0;NA;164564;1;2020-05-29;262
2020-05-27;"Košický kraj";0;0;0;0;NA;164564;0;2020-05-27;261
2020-05-26;"Košický kraj";1;0;0;0;NA;164564;1;2020-05-26;261
2020-05-25;"Košický kraj";1;0;0;0;NA;164564;1;2020-05-25;260
2020-05-24;"Košický kraj";0;0;0;0;NA;164564;0;2020-05-24;259
2020-05-23;"Košický kraj";0;0;0;0;NA;164564;0;2020-05-23;259
2020-05-22;"Košický kraj";0;0;0;0;NA;164564;0;2020-05-22;259
2020-05-21;"Košický kraj";0;0;0;0;NA;164564;0;2020-05-21;259
2020-05-20;"Košický kraj";3;0;0;0;NA;164564;3;2020-05-20;259
2020-05-19;"Košický kraj";0;0;0;0;NA;164564;0;2020-05-19;256
2020-05-17;"Košický kraj";1;0;0;0;NA;164564;1;2020-05-17;256
2020-05-16;"Košický kraj";1;0;0;0;NA;164564;1;2020-05-16;255
2020-05-15;"Košický kraj";10;0;0;0;NA;164564;10;2020-05-15;254
2020-05-14;"Košický kraj";1;0;0;0;NA;164564;1;2020-05-14;244
2020-05-13;"Košický kraj";6;0;0;0;NA;164564;6;2020-05-13;243
2020-05-12;"Košický kraj";0;0;0;0;NA;164564;0;2020-05-12;237
2020-05-11;"Košický kraj";0;0;0;0;NA;164564;0;2020-05-11;237
2020-05-09;"Košický kraj";0;0;0;0;NA;164564;0;2020-05-09;237
2020-05-07;"Košický kraj";0;0;0;0;NA;164564;0;2020-05-07;237
2020-05-06;"Košický kraj";1;0;0;0;NA;164564;1;2020-05-06;237
2020-05-05;"Košický kraj";0;0;0;0;NA;164564;0;2020-05-05;236
2020-05-04;"Košický kraj";0;0;0;0;NA;164564;0;2020-05-04;236
2020-05-03;"Košický kraj";0;0;0;0;NA;164564;0;2020-05-03;236
2020-05-02;"Košický kraj";1;0;0;0;NA;164564;1;2020-05-02;236
2020-05-01;"Košický kraj";0;0;0;0;NA;164564;0;2020-05-01;235
2020-04-30;"Košický kraj";1;0;0;0;NA;164564;1;2020-04-30;235
2020-04-29;"Košický kraj";1;0;0;0;NA;164564;1;2020-04-29;234
2020-04-28;"Košický kraj";1;0;0;0;NA;164564;1;2020-04-28;233
2020-04-27;"Košický kraj";1;0;0;0;NA;164564;1;2020-04-27;232
2020-04-26;"Košický kraj";0;0;0;0;NA;164564;0;2020-04-26;231
2020-04-25;"Košický kraj";0;0;0;0;NA;164564;0;2020-04-25;231
2020-04-24;"Košický kraj";3;0;0;0;NA;164564;3;2020-04-24;231
2020-04-23;"Košický kraj";4;0;0;0;NA;164564;4;2020-04-23;228
2020-04-22;"Košický kraj";21;0;0;0;NA;164564;21;2020-04-22;224
2020-04-21;"Košický kraj";4;0;0;0;NA;164564;4;2020-04-21;203
2020-04-20;"Košický kraj";0;0;0;0;NA;164564;0;2020-04-20;199
2020-04-19;"Košický kraj";1;0;0;0;NA;164564;1;2020-04-19;199
2020-04-18;"Košický kraj";2;0;0;0;NA;164564;2;2020-04-18;198
2020-04-17;"Košický kraj";7;0;0;0;NA;164564;7;2020-04-17;196
2020-04-16;"Košický kraj";29;0;0;0;NA;164564;29;2020-04-16;189
2020-04-15;"Košický kraj";50;0;0;0;NA;164564;50;2020-04-15;160
2020-04-14;"Košický kraj";4;0;0;0;NA;164564;4;2020-04-14;110
2020-04-13;"Košický kraj";5;0;0;0;NA;164564;5;2020-04-13;106
2020-04-12;"Košický kraj";4;0;0;0;NA;164564;4;2020-04-12;101
2020-04-11;"Košický kraj";2;0;0;0;NA;164564;2;2020-04-11;97
2020-04-10;"Košický kraj";1;0;0;0;NA;164564;1;2020-04-10;95
2020-04-09;"Košický kraj";4;0;0;0;NA;164564;4;2020-04-09;94
2020-04-08;"Košický kraj";5;0;0;0;NA;164564;5;2020-04-08;90
2020-04-07;"Košický kraj";34;0;0;0;NA;164564;34;2020-04-07;85
2020-04-06;"Košický kraj";6;0;0;0;NA;164564;6;2020-04-06;51
2020-04-05;"Košický kraj";4;0;0;0;NA;164564;4;2020-04-05;45
2020-04-04;"Košický kraj";5;0;0;0;NA;164564;5;2020-04-04;41
2020-04-03;"Košický kraj";4;0;0;0;NA;164564;4;2020-04-03;36
2020-04-02;"Košický kraj";3;0;0;0;NA;164564;3;2020-04-02;32
2020-04-01;"Košický kraj";3;0;0;0;NA;164564;3;2020-04-01;29
2020-03-31;"Košický kraj";1;0;0;0;NA;164564;1;2020-03-31;26
2020-03-30;"Košický kraj";5;0;0;0;NA;164564;5;2020-03-30;25
2020-03-29;"Košický kraj";0;0;0;0;NA;164564;0;2020-03-29;20
2020-03-28;"Košický kraj";1;0;0;0;NA;164564;1;2020-03-28;20
2020-03-27;"Košický kraj";1;0;0;0;NA;164564;1;2020-03-27;19
2020-03-26;"Košický kraj";3;0;0;0;NA;164564;3;2020-03-26;18
2020-03-25;"Košický kraj";2;0;0;0;NA;164564;2;2020-03-25;15
2020-03-24;"Košický kraj";0;0;0;0;NA;164564;0;2020-03-24;13
2020-03-23;"Košický kraj";2;0;0;0;NA;164564;2;2020-03-23;13
2020-03-22;"Košický kraj";0;0;0;0;NA;164564;0;2020-03-22;11
2020-03-21;"Košický kraj";3;0;0;0;NA;164564;3;2020-03-21;11
2020-03-20;"Košický kraj";1;0;0;0;NA;164564;1;2020-03-20;8
2020-03-19;"Košický kraj";0;0;0;0;NA;164564;0;2020-03-19;7
2020-03-18;"Košický kraj";0;0;0;0;NA;164564;0;2020-03-18;7
2020-03-17;"Košický kraj";0;0;0;0;NA;164564;0;2020-03-17;7
2020-03-16;"Košický kraj";3;0;0;0;NA;164564;3;2020-03-16;7
2020-03-15;"Košický kraj";1;0;0;0;NA;164564;1;2020-03-15;4
2020-03-14;"Košický kraj";0;0;0;0;NA;164564;0;2020-03-14;3
2020-03-13;"Košický kraj";2;0;0;0;NA;164564;2;2020-03-13;3
2020-03-12;"Košický kraj";0;0;0;0;NA;164564;0;2020-03-12;1
2020-03-11;"Košický kraj";0;0;0;0;NA;164564;0;2020-03-11;1
2020-03-09;"Košický kraj";1;0;0;0;NA;164564;1;2020-03-09;1
2020-03-08;"Košický kraj";0;0;0;0;NA;164564;0;2020-03-08;0
2020-03-07;"Košický kraj";0;0;0;0;NA;164564;0;2020-03-07;0
2020-03-06;"Košický kraj";0;0;0;0;NA;164564;0;2020-03-06;0
2021-12-02;"Nitriansky kraj";1388;16;0;16;62696;126479;1388;2021-12-02;126479
2021-12-01;"Nitriansky kraj";982;3131;218;3349;NA;126479;1200;2021-12-01;125091
2021-11-30;"Nitriansky kraj";751;4640;210;4850;NA;126479;961;2021-11-30;123891
2021-11-29;"Nitriansky kraj";665;9011;476;9487;NA;126479;1141;2021-11-29;122930
2021-11-28;"Nitriansky kraj";357;6132;299;6431;NA;126479;656;2021-11-28;121789
2021-11-27;"Nitriansky kraj";560;2879;281;3160;NA;126479;841;2021-11-27;121133
2021-11-26;"Nitriansky kraj";824;5458;289;5747;NA;126479;1113;2021-11-26;120292
2021-11-25;"Nitriansky kraj";847;4151;342;4493;NA;126479;1189;2021-11-25;119179
2021-11-24;"Nitriansky kraj";875;4348;324;4672;NA;126479;1199;2021-11-24;117990
2021-11-23;"Nitriansky kraj";1103;5148;353;5501;NA;126479;1456;2021-11-23;116791
2021-11-22;"Nitriansky kraj";545;7065;465;7530;NA;126479;1010;2021-11-22;115335
2021-11-21;"Nitriansky kraj";345;3345;313;3658;NA;126479;658;2021-11-21;114325
2021-11-20;"Nitriansky kraj";579;1865;252;2117;NA;126479;831;2021-11-20;113667
2021-11-19;"Nitriansky kraj";571;4211;349;4560;NA;126479;920;2021-11-19;112836
2021-11-18;"Nitriansky kraj";677;4881;420;5301;NA;126479;1097;2021-11-18;111916
2021-11-17;"Nitriansky kraj";479;1622;207;1829;NA;126479;686;2021-11-17;110819
2021-11-16;"Nitriansky kraj";668;3816;265;4081;NA;126479;933;2021-11-16;110133
2021-11-15;"Nitriansky kraj";556;6012;440;6452;NA;126479;996;2021-11-15;109200
2021-11-14;"Nitriansky kraj";229;2796;259;3055;NA;126479;488;2021-11-14;108204
2021-11-13;"Nitriansky kraj";387;1473;201;1674;NA;126479;588;2021-11-13;107716
2021-11-12;"Nitriansky kraj";552;3017;269;3286;NA;126479;821;2021-11-12;107128
2021-11-11;"Nitriansky kraj";539;3541;238;3779;NA;126479;777;2021-11-11;106307
2021-11-10;"Nitriansky kraj";411;3494;234;3728;NA;126479;645;2021-11-10;105530
2021-11-09;"Nitriansky kraj";413;3313;210;3523;NA;126479;623;2021-11-09;104885
2021-11-08;"Nitriansky kraj";464;4936;331;5267;NA;126479;795;2021-11-08;104262
2021-11-07;"Nitriansky kraj";209;2074;161;2235;NA;126479;370;2021-11-07;103467
2021-11-06;"Nitriansky kraj";236;1407;114;1521;NA;126479;350;2021-11-06;103097
2021-11-05;"Nitriansky kraj";407;2583;185;2768;NA;126479;592;2021-11-05;102747
2021-11-04;"Nitriansky kraj";437;3083;168;3251;NA;126479;605;2021-11-04;102155
2021-11-03;"Nitriansky kraj";525;2891;157;3048;NA;126479;682;2021-11-03;101550
2021-11-02;"Nitriansky kraj";320;4279;239;4518;NA;126479;559;2021-11-02;100868
2021-11-01;"Nitriansky kraj";136;712;61;773;NA;126479;197;2021-11-01;100309
2021-10-31;"Nitriansky kraj";109;1234;114;1348;NA;126479;223;2021-10-31;100112
2021-10-30;"Nitriansky kraj";202;1218;82;1300;NA;126479;284;2021-10-30;99889
2021-10-29;"Nitriansky kraj";347;2481;120;2601;NA;126479;467;2021-10-29;99605
2021-10-28;"Nitriansky kraj";281;2603;95;2698;NA;126479;376;2021-10-28;99138
2021-10-27;"Nitriansky kraj";340;2923;112;3035;NA;126479;452;2021-10-27;98762
2021-10-26;"Nitriansky kraj";297;2926;117;3043;NA;126479;414;2021-10-26;98310
2021-10-25;"Nitriansky kraj";171;3599;124;3723;NA;126479;295;2021-10-25;97896
2021-10-24;"Nitriansky kraj";58;1914;74;1988;NA;126479;132;2021-10-24;97601
2021-10-23;"Nitriansky kraj";173;1815;77;1892;NA;126479;250;2021-10-23;97469
2021-10-22;"Nitriansky kraj";202;2216;68;2284;NA;126479;270;2021-10-22;97219
2021-10-21;"Nitriansky kraj";214;2793;65;2858;NA;126479;279;2021-10-21;96949
2021-10-20;"Nitriansky kraj";218;2328;74;2402;NA;126479;292;2021-10-20;96670
2021-10-19;"Nitriansky kraj";250;2929;65;2994;NA;126479;315;2021-10-19;96378
2021-10-18;"Nitriansky kraj";81;3259;90;3349;NA;126479;171;2021-10-18;96063
2021-10-17;"Nitriansky kraj";36;3010;92;3102;NA;126479;128;2021-10-17;95892
2021-10-16;"Nitriansky kraj";37;1477;38;1515;NA;126479;75;2021-10-16;95764
2021-10-15;"Nitriansky kraj";145;2653;34;2687;NA;126479;179;2021-10-15;95689
2021-10-14;"Nitriansky kraj";95;2389;30;2419;NA;126479;125;2021-10-14;95510
2021-10-13;"Nitriansky kraj";91;2248;36;2284;NA;126479;127;2021-10-13;95385
2021-10-12;"Nitriansky kraj";119;2905;34;2939;NA;126479;153;2021-10-12;95258
2021-10-11;"Nitriansky kraj";91;2703;42;2745;NA;126479;133;2021-10-11;95105
2021-10-10;"Nitriansky kraj";33;1527;22;1549;NA;126479;55;2021-10-10;94972
2021-10-09;"Nitriansky kraj";17;1395;17;1412;NA;126479;34;2021-10-09;94917
2021-10-08;"Nitriansky kraj";61;3004;37;3041;NA;126479;98;2021-10-08;94883
2021-10-07;"Nitriansky kraj";59;2829;30;2859;NA;126479;89;2021-10-07;94785
2021-10-06;"Nitriansky kraj";66;2657;28;2685;NA;126479;94;2021-10-06;94696
2021-10-05;"Nitriansky kraj";97;2536;32;2568;NA;126479;129;2021-10-05;94602
2021-10-04;"Nitriansky kraj";56;3263;49;3312;NA;126479;105;2021-10-04;94473
2021-10-03;"Nitriansky kraj";10;1591;24;1615;NA;126479;34;2021-10-03;94368
2021-10-02;"Nitriansky kraj";46;1567;20;1587;NA;126479;66;2021-10-02;94334
2021-10-01;"Nitriansky kraj";26;2830;34;2864;NA;126479;60;2021-10-01;94268
2021-09-30;"Nitriansky kraj";66;2468;15;2483;NA;126479;81;2021-09-30;94208
2021-09-29;"Nitriansky kraj";92;2266;16;2282;NA;126479;108;2021-09-29;94127
2021-09-28;"Nitriansky kraj";86;2893;27;2920;NA;126479;113;2021-09-28;94019
2021-09-27;"Nitriansky kraj";50;3633;41;3674;NA;126479;91;2021-09-27;93906
2021-09-26;"Nitriansky kraj";12;1635;20;1655;NA;126479;32;2021-09-26;93815
2021-09-25;"Nitriansky kraj";43;1456;20;1476;NA;126479;63;2021-09-25;93783
2021-09-24;"Nitriansky kraj";35;2783;15;2798;NA;126479;50;2021-09-24;93720
2021-09-23;"Nitriansky kraj";69;2503;20;2523;NA;126479;89;2021-09-23;93670
2021-09-22;"Nitriansky kraj";68;2380;17;2397;NA;126479;85;2021-09-22;93581
2021-09-21;"Nitriansky kraj";70;2684;30;2714;NA;126479;100;2021-09-21;93496
2021-09-20;"Nitriansky kraj";41;2497;21;2518;NA;126479;62;2021-09-20;93396
2021-09-19;"Nitriansky kraj";16;1553;20;1573;NA;126479;36;2021-09-19;93334
2021-09-18;"Nitriansky kraj";42;1421;19;1440;NA;126479;61;2021-09-18;93298
2021-09-17;"Nitriansky kraj";54;2757;30;2787;NA;126479;84;2021-09-17;93237
2021-09-16;"Nitriansky kraj";55;2499;44;2543;NA;126479;99;2021-09-16;93153
2021-09-15;"Nitriansky kraj";34;538;12;550;NA;126479;46;2021-09-15;93054
2021-09-14;"Nitriansky kraj";52;1821;20;1841;NA;126479;72;2021-09-14;93008
2021-09-13;"Nitriansky kraj";27;2373;27;2400;NA;126479;54;2021-09-13;92936
2021-09-12;"Nitriansky kraj";4;1182;17;1199;NA;126479;21;2021-09-12;92882
2021-09-11;"Nitriansky kraj";36;1181;8;1189;NA;126479;44;2021-09-11;92861
2021-09-10;"Nitriansky kraj";25;2133;12;2145;NA;126479;37;2021-09-10;92817
2021-09-09;"Nitriansky kraj";15;1611;20;1631;NA;126479;35;2021-09-09;92780
2021-09-08;"Nitriansky kraj";30;1463;22;1485;NA;126479;52;2021-09-08;92745
2021-09-07;"Nitriansky kraj";35;1460;9;1469;NA;126479;44;2021-09-07;92693
2021-09-06;"Nitriansky kraj";19;1668;27;1695;NA;126479;46;2021-09-06;92649
2021-09-05;"Nitriansky kraj";10;1007;8;1015;NA;126479;18;2021-09-05;92603
2021-09-04;"Nitriansky kraj";18;1119;10;1129;NA;126479;28;2021-09-04;92585
2021-09-03;"Nitriansky kraj";20;1743;17;1760;NA;126479;37;2021-09-03;92557
2021-09-02;"Nitriansky kraj";16;1389;14;1403;NA;126479;30;2021-09-02;92520
2021-09-01;"Nitriansky kraj";9;322;2;324;NA;126479;11;2021-09-01;92490
2021-08-31;"Nitriansky kraj";10;1360;6;1366;NA;126479;16;2021-08-31;92479
2021-08-30;"Nitriansky kraj";8;1381;10;1391;NA;126479;18;2021-08-30;92463
2021-08-29;"Nitriansky kraj";2;450;1;451;NA;126479;3;2021-08-29;92445
2021-08-28;"Nitriansky kraj";5;1071;3;1074;NA;126479;8;2021-08-28;92442
2021-08-27;"Nitriansky kraj";7;1804;4;1808;NA;126479;11;2021-08-27;92434
2021-08-26;"Nitriansky kraj";2;1255;6;1261;NA;126479;8;2021-08-26;92423
2021-08-25;"Nitriansky kraj";15;1087;3;1090;NA;126479;18;2021-08-25;92415
2021-08-24;"Nitriansky kraj";6;990;2;992;NA;126479;8;2021-08-24;92397
2021-08-23;"Nitriansky kraj";13;1271;4;1275;NA;126479;17;2021-08-23;92389
2021-08-22;"Nitriansky kraj";0;1167;3;1170;NA;126479;3;2021-08-22;92372
2021-08-21;"Nitriansky kraj";1;853;2;855;NA;126479;3;2021-08-21;92369
2021-08-20;"Nitriansky kraj";8;1580;5;1585;NA;126479;13;2021-08-20;92366
2021-08-19;"Nitriansky kraj";11;1167;4;1171;NA;126479;15;2021-08-19;92353
2021-08-18;"Nitriansky kraj";8;1180;7;1187;NA;126479;15;2021-08-18;92338
2021-08-17;"Nitriansky kraj";4;1035;3;1038;NA;126479;7;2021-08-17;92323
2021-08-16;"Nitriansky kraj";7;1129;4;1133;NA;126479;11;2021-08-16;92316
2021-08-15;"Nitriansky kraj";2;662;1;663;NA;126479;3;2021-08-15;92305
2021-08-14;"Nitriansky kraj";1;878;5;883;NA;126479;6;2021-08-14;92302
2021-08-13;"Nitriansky kraj";0;957;1;958;NA;126479;1;2021-08-13;92296
2021-08-12;"Nitriansky kraj";5;765;0;765;NA;126479;5;2021-08-12;92295
2021-08-11;"Nitriansky kraj";3;527;1;528;NA;126479;4;2021-08-11;92290
2021-08-10;"Nitriansky kraj";3;570;1;571;NA;126479;4;2021-08-10;92286
2021-08-09;"Nitriansky kraj";3;992;1;993;NA;126479;4;2021-08-09;92282
2021-08-08;"Nitriansky kraj";0;668;1;669;NA;126479;1;2021-08-08;92278
2021-08-07;"Nitriansky kraj";0;557;1;558;NA;126479;1;2021-08-07;92277
2021-08-06;"Nitriansky kraj";5;799;0;799;NA;126479;5;2021-08-06;92276
2021-08-05;"Nitriansky kraj";6;612;0;612;NA;126479;6;2021-08-05;92271
2021-08-04;"Nitriansky kraj";1;497;2;499;NA;126479;3;2021-08-04;92265
2021-08-03;"Nitriansky kraj";5;1455;0;1455;NA;126479;5;2021-08-03;92262
2021-08-02;"Nitriansky kraj";1;683;4;687;NA;126479;5;2021-08-02;92257
2021-08-01;"Nitriansky kraj";1;606;0;606;NA;126479;1;2021-08-01;92252
2021-07-31;"Nitriansky kraj";1;514;1;515;NA;126479;2;2021-07-31;92251
2021-07-30;"Nitriansky kraj";2;827;0;827;NA;126479;2;2021-07-30;92249
2021-07-29;"Nitriansky kraj";3;720;2;722;NA;126479;5;2021-07-29;92247
2021-07-28;"Nitriansky kraj";4;598;0;598;NA;126479;4;2021-07-28;92242
2021-07-27;"Nitriansky kraj";12;602;1;603;NA;126479;13;2021-07-27;92238
2021-07-26;"Nitriansky kraj";7;970;1;971;NA;126479;8;2021-07-26;92225
2021-07-25;"Nitriansky kraj";1;654;1;655;NA;126479;2;2021-07-25;92217
2021-07-24;"Nitriansky kraj";0;620;0;620;NA;126479;0;2021-07-24;92215
2021-07-23;"Nitriansky kraj";3;845;1;846;NA;126479;4;2021-07-23;92215
2021-07-22;"Nitriansky kraj";5;689;0;689;NA;126479;5;2021-07-22;92211
2021-07-21;"Nitriansky kraj";6;650;2;652;NA;126479;8;2021-07-21;92206
2021-07-20;"Nitriansky kraj";1;527;1;528;NA;126479;2;2021-07-20;92198
2021-07-19;"Nitriansky kraj";2;965;0;965;NA;126479;2;2021-07-19;92196
2021-07-18;"Nitriansky kraj";1;747;0;747;NA;126479;1;2021-07-18;92194
2021-07-17;"Nitriansky kraj";5;612;0;612;NA;126479;5;2021-07-17;92193
2021-07-16;"Nitriansky kraj";2;876;0;876;NA;126479;2;2021-07-16;92188
2021-07-15;"Nitriansky kraj";11;708;0;708;NA;126479;11;2021-07-15;92186
2021-07-14;"Nitriansky kraj";4;646;0;646;NA;126479;4;2021-07-14;92175
2021-07-13;"Nitriansky kraj";2;697;2;699;NA;126479;4;2021-07-13;92171
2021-07-12;"Nitriansky kraj";1;819;0;819;NA;126479;1;2021-07-12;92167
2021-07-11;"Nitriansky kraj";1;961;0;961;NA;126479;1;2021-07-11;92166
2021-07-10;"Nitriansky kraj";1;630;0;630;NA;126479;1;2021-07-10;92165
2021-07-09;"Nitriansky kraj";3;1000;0;1000;NA;126479;3;2021-07-09;92164
2021-07-08;"Nitriansky kraj";0;683;0;683;NA;126479;0;2021-07-08;92161
2021-07-07;"Nitriansky kraj";2;935;2;937;NA;126479;4;2021-07-07;92161
2021-07-06;"Nitriansky kraj";1;1269;1;1270;NA;126479;2;2021-07-06;92157
2021-07-05;"Nitriansky kraj";1;507;0;507;NA;126479;1;2021-07-05;92155
2021-07-04;"Nitriansky kraj";0;821;1;822;NA;126479;1;2021-07-04;92154
2021-07-03;"Nitriansky kraj";0;611;0;611;NA;126479;0;2021-07-03;92153
2021-07-02;"Nitriansky kraj";0;1259;0;1259;NA;126479;0;2021-07-02;92153
2021-07-01;"Nitriansky kraj";0;339;1;340;NA;126479;1;2021-07-01;92153
2021-06-30;"Nitriansky kraj";1;6777;2;6779;NA;126479;3;2021-06-30;92152
2021-06-29;"Nitriansky kraj";1;3536;0;3536;NA;126479;1;2021-06-29;92149
2021-06-28;"Nitriansky kraj";3;4393;0;4393;NA;126479;3;2021-06-28;92148
2021-06-27;"Nitriansky kraj";0;3263;0;3263;NA;126479;0;2021-06-27;92145
2021-06-26;"Nitriansky kraj";1;4845;2;4847;NA;126479;3;2021-06-26;92145
2021-06-25;"Nitriansky kraj";8;5174;1;5175;NA;126479;9;2021-06-25;92142
2021-06-24;"Nitriansky kraj";1;3354;0;3354;NA;126479;1;2021-06-24;92133
2021-06-23;"Nitriansky kraj";1;3033;0;3033;NA;126479;1;2021-06-23;92132
2021-06-22;"Nitriansky kraj";1;3240;3;3243;NA;126479;4;2021-06-22;92131
2021-06-21;"Nitriansky kraj";8;5362;8;5370;NA;126479;16;2021-06-21;92127
2021-06-20;"Nitriansky kraj";0;4437;6;4443;NA;126479;6;2021-06-20;92111
2021-06-19;"Nitriansky kraj";0;5750;4;5754;NA;126479;4;2021-06-19;92105
2021-06-18;"Nitriansky kraj";4;6453;3;6456;NA;126479;7;2021-06-18;92101
2021-06-17;"Nitriansky kraj";5;4152;1;4153;NA;126479;6;2021-06-17;92094
2021-06-16;"Nitriansky kraj";4;3694;3;3697;NA;126479;7;2021-06-16;92088
2021-06-15;"Nitriansky kraj";1;3995;0;3995;NA;126479;1;2021-06-15;92081
2021-06-14;"Nitriansky kraj";0;5875;3;5878;NA;126479;3;2021-06-14;92080
2021-06-13;"Nitriansky kraj";0;6073;3;6076;NA;126479;3;2021-06-13;92077
2021-06-12;"Nitriansky kraj";1;8024;1;8025;NA;126479;2;2021-06-12;92074
2021-06-11;"Nitriansky kraj";3;6891;4;6895;NA;126479;7;2021-06-11;92072
2021-06-10;"Nitriansky kraj";7;4539;1;4540;NA;126479;8;2021-06-10;92065
2021-06-09;"Nitriansky kraj";2;4706;2;4708;NA;126479;4;2021-06-09;92057
2021-06-08;"Nitriansky kraj";8;4239;3;4242;NA;126479;11;2021-06-08;92053
2021-06-07;"Nitriansky kraj";6;5841;8;5849;NA;126479;14;2021-06-07;92042
2021-06-06;"Nitriansky kraj";0;6981;4;6985;NA;126479;4;2021-06-06;92028
2021-06-05;"Nitriansky kraj";6;8529;9;8538;NA;126479;15;2021-06-05;92024
2021-06-04;"Nitriansky kraj";9;7639;5;7644;NA;126479;14;2021-06-04;92009
2021-06-03;"Nitriansky kraj";2;5064;6;5070;NA;126479;8;2021-06-03;91995
2021-06-02;"Nitriansky kraj";11;5119;11;5130;NA;126479;22;2021-06-02;91987
2021-06-01;"Nitriansky kraj";3;4847;2;4849;NA;126479;5;2021-06-01;91965
2021-05-31;"Nitriansky kraj";8;8933;8;8941;NA;126479;16;2021-05-31;91960
2021-05-30;"Nitriansky kraj";1;9067;8;9075;NA;126479;9;2021-05-30;91944
2021-05-29;"Nitriansky kraj";2;12799;7;12806;NA;126479;9;2021-05-29;91935
2021-05-28;"Nitriansky kraj";10;8872;6;8878;NA;126479;16;2021-05-28;91926
2021-05-27;"Nitriansky kraj";4;6164;5;6169;NA;126479;9;2021-05-27;91910
2021-05-26;"Nitriansky kraj";11;8509;10;8519;NA;126479;21;2021-05-26;91901
2021-05-25;"Nitriansky kraj";15;7342;8;7350;NA;126479;23;2021-05-25;91880
2021-05-24;"Nitriansky kraj";14;9816;17;9833;NA;126479;31;2021-05-24;91857
2021-05-23;"Nitriansky kraj";1;9456;13;9469;NA;126479;14;2021-05-23;91826
2021-05-22;"Nitriansky kraj";7;16939;11;16950;NA;126479;18;2021-05-22;91812
2021-05-21;"Nitriansky kraj";18;10632;15;10647;NA;126479;33;2021-05-21;91794
2021-05-20;"Nitriansky kraj";8;7185;7;7192;NA;126479;15;2021-05-20;91761
2021-05-19;"Nitriansky kraj";20;6787;14;6801;NA;126479;34;2021-05-19;91746
2021-05-18;"Nitriansky kraj";23;7791;18;7809;NA;126479;41;2021-05-18;91712
2021-05-17;"Nitriansky kraj";22;9774;20;9794;NA;126479;42;2021-05-17;91671
2021-05-16;"Nitriansky kraj";4;13830;15;13845;NA;126479;19;2021-05-16;91629
2021-05-15;"Nitriansky kraj";5;25389;23;25412;NA;126479;28;2021-05-15;91610
2021-05-14;"Nitriansky kraj";18;13385;23;13408;NA;126479;41;2021-05-14;91582
2021-05-13;"Nitriansky kraj";24;8289;19;8308;NA;126479;43;2021-05-13;91541
2021-05-12;"Nitriansky kraj";10;7682;26;7708;NA;126479;36;2021-05-12;91498
2021-05-11;"Nitriansky kraj";36;8163;13;8176;NA;126479;49;2021-05-11;91462
2021-05-10;"Nitriansky kraj";16;13800;42;13842;NA;126479;58;2021-05-10;91413
2021-05-09;"Nitriansky kraj";8;21879;35;21914;NA;126479;43;2021-05-09;91355
2021-05-08;"Nitriansky kraj";0;24318;29;24347;NA;126479;29;2021-05-08;91312
2021-05-07;"Nitriansky kraj";32;14915;20;14935;NA;126479;52;2021-05-07;91283
2021-05-06;"Nitriansky kraj";30;9463;20;9483;NA;126479;50;2021-05-06;91231
2021-05-05;"Nitriansky kraj";19;8527;23;8550;NA;126479;42;2021-05-05;91181
2021-05-04;"Nitriansky kraj";46;9380;27;9407;NA;126479;73;2021-05-04;91139
2021-05-03;"Nitriansky kraj";32;14490;44;14534;NA;126479;76;2021-05-03;91066
2021-05-02;"Nitriansky kraj";4;31751;46;31797;NA;126479;50;2021-05-02;90990
2021-05-01;"Nitriansky kraj";23;60451;43;60494;NA;126479;66;2021-05-01;90940
2021-04-30;"Nitriansky kraj";28;31803;53;31856;NA;126479;81;2021-04-30;90874
2021-04-29;"Nitriansky kraj";27;14265;34;14299;NA;126479;61;2021-04-29;90793
2021-04-28;"Nitriansky kraj";36;14716;45;14761;NA;126479;81;2021-04-28;90732
2021-04-27;"Nitriansky kraj";51;13154;35;13189;NA;126479;86;2021-04-27;90651
2021-04-26;"Nitriansky kraj";38;21029;44;21073;NA;126479;82;2021-04-26;90565
2021-04-25;"Nitriansky kraj";7;44312;46;44358;NA;126479;53;2021-04-25;90483
2021-04-24;"Nitriansky kraj";23;93455;72;93527;NA;126479;95;2021-04-24;90430
2021-04-23;"Nitriansky kraj";54;35145;51;35196;NA;126479;105;2021-04-23;90335
2021-04-22;"Nitriansky kraj";32;15435;44;15479;NA;126479;76;2021-04-22;90230
2021-04-21;"Nitriansky kraj";38;14228;45;14273;NA;126479;83;2021-04-21;90154
2021-04-20;"Nitriansky kraj";67;16058;51;16109;NA;126479;118;2021-04-20;90071
2021-04-19;"Nitriansky kraj";35;24819;59;24878;NA;126479;94;2021-04-19;89953
2021-04-18;"Nitriansky kraj";0;39569;27;39596;NA;126479;27;2021-04-18;89859
2021-04-17;"Nitriansky kraj";34;92102;82;92184;NA;126479;116;2021-04-17;89832
2021-04-16;"Nitriansky kraj";46;32348;37;32385;NA;126479;83;2021-04-16;89716
2021-04-15;"Nitriansky kraj";75;16215;52;16267;NA;126479;127;2021-04-15;89633
2021-04-14;"Nitriansky kraj";43;15303;42;15345;NA;126479;85;2021-04-14;89506
2021-04-13;"Nitriansky kraj";110;15104;44;15148;NA;126479;154;2021-04-13;89421
2021-04-12;"Nitriansky kraj";29;22817;50;22867;NA;126479;79;2021-04-12;89267
2021-04-11;"Nitriansky kraj";1;37537;31;37568;NA;126479;32;2021-04-11;89188
2021-04-10;"Nitriansky kraj";35;95851;115;95966;NA;126479;150;2021-04-10;89156
2021-04-09;"Nitriansky kraj";69;30669;58;30727;NA;126479;127;2021-04-09;89006
2021-04-08;"Nitriansky kraj";71;15361;36;15397;NA;126479;107;2021-04-08;88879
2021-04-07;"Nitriansky kraj";64;18541;47;18588;NA;126479;111;2021-04-07;88772
2021-04-06;"Nitriansky kraj";65;33218;112;33330;NA;126479;177;2021-04-06;88661
2021-04-05;"Nitriansky kraj";37;12673;48;12721;NA;126479;85;2021-04-05;88484
2021-04-04;"Nitriansky kraj";5;17887;35;17922;NA;126479;40;2021-04-04;88399
2021-04-03;"Nitriansky kraj";26;85465;153;85618;NA;126479;179;2021-04-03;88359
2021-04-02;"Nitriansky kraj";32;18743;46;18789;NA;126479;78;2021-04-02;88180
2021-04-01;"Nitriansky kraj";63;24610;83;24693;NA;126479;146;2021-04-01;88102
2021-03-31;"Nitriansky kraj";73;21752;94;21846;NA;126479;167;2021-03-31;87956
2021-03-30;"Nitriansky kraj";125;17122;83;17205;NA;126479;208;2021-03-30;87789
2021-03-29;"Nitriansky kraj";81;25139;100;25239;NA;126479;181;2021-03-29;87581
2021-03-28;"Nitriansky kraj";6;45581;106;45687;NA;126479;112;2021-03-28;87400
2021-03-27;"Nitriansky kraj";39;104104;174;104278;NA;126479;213;2021-03-27;87288
2021-03-26;"Nitriansky kraj";90;40444;115;40559;NA;126479;205;2021-03-26;87075
2021-03-25;"Nitriansky kraj";95;19219;94;19313;NA;126479;189;2021-03-25;86870
2021-03-24;"Nitriansky kraj";90;14787;91;14878;NA;126479;181;2021-03-24;86681
2021-03-23;"Nitriansky kraj";167;16753;66;16819;NA;126479;233;2021-03-23;86500
2021-03-22;"Nitriansky kraj";101;24886;125;25011;NA;126479;226;2021-03-22;86267
2021-03-21;"Nitriansky kraj";27;42773;99;42872;NA;126479;126;2021-03-21;86041
2021-03-20;"Nitriansky kraj";36;100640;207;100847;NA;126479;243;2021-03-20;85915
2021-03-19;"Nitriansky kraj";76;37312;102;37414;NA;126479;178;2021-03-19;85672
2021-03-18;"Nitriansky kraj";103;20051;113;20164;NA;126479;216;2021-03-18;85494
2021-03-17;"Nitriansky kraj";87;15839;127;15966;NA;126479;214;2021-03-17;85278
2021-03-16;"Nitriansky kraj";172;18085;121;18206;NA;126479;293;2021-03-16;85064
2021-03-15;"Nitriansky kraj";130;24481;165;24646;NA;126479;295;2021-03-15;84771
2021-03-14;"Nitriansky kraj";3;45770;107;45877;NA;126479;110;2021-03-14;84476
2021-03-13;"Nitriansky kraj";65;112573;242;112815;NA;126479;307;2021-03-13;84366
2021-03-12;"Nitriansky kraj";127;40777;159;40936;NA;126479;286;2021-03-12;84059
2021-03-11;"Nitriansky kraj";131;18686;130;18816;NA;126479;261;2021-03-11;83773
2021-03-10;"Nitriansky kraj";96;17422;143;17565;NA;126479;239;2021-03-10;83512
2021-03-09;"Nitriansky kraj";260;17635;149;17784;NA;126479;409;2021-03-09;83273
2021-03-08;"Nitriansky kraj";145;27214;172;27386;NA;126479;317;2021-03-08;82864
2021-03-07;"Nitriansky kraj";48;46867;185;47052;NA;126479;233;2021-03-07;82547
2021-03-06;"Nitriansky kraj";86;112027;327;112354;NA;126479;413;2021-03-06;82314
2021-03-05;"Nitriansky kraj";133;39068;200;39268;NA;126479;333;2021-03-05;81901
2021-03-04;"Nitriansky kraj";176;18340;173;18513;NA;126479;349;2021-03-04;81568
2021-03-03;"Nitriansky kraj";172;17210;177;17387;NA;126479;349;2021-03-03;81219
2021-03-02;"Nitriansky kraj";274;21003;366;21369;NA;126479;640;2021-03-02;80870
2021-03-01;"Nitriansky kraj";133;27881;279;28160;NA;126479;412;2021-03-01;80230
2021-02-28;"Nitriansky kraj";80;40866;218;41084;NA;126479;298;2021-02-28;79818
2021-02-27;"Nitriansky kraj";101;106352;496;106848;NA;126479;597;2021-02-27;79520
2021-02-26;"Nitriansky kraj";109;36788;308;37096;NA;126479;417;2021-02-26;78923
2021-02-25;"Nitriansky kraj";188;15243;212;15455;NA;126479;400;2021-02-25;78506
2021-02-24;"Nitriansky kraj";125;13833;260;14093;NA;126479;385;2021-02-24;78106
2021-02-23;"Nitriansky kraj";273;15402;273;15675;NA;126479;546;2021-02-23;77721
2021-02-22;"Nitriansky kraj";154;26478;330;26808;NA;126479;484;2021-02-22;77175
2021-02-21;"Nitriansky kraj";22;43664;320;43984;NA;126479;342;2021-02-21;76691
2021-02-20;"Nitriansky kraj";128;109038;586;109624;NA;126479;714;2021-02-20;76349
2021-02-19;"Nitriansky kraj";173;36849;328;37177;NA;126479;501;2021-02-19;75635
2021-02-18;"Nitriansky kraj";202;17045;275;17320;NA;126479;477;2021-02-18;75134
2021-02-17;"Nitriansky kraj";198;12080;310;12390;NA;126479;508;2021-02-17;74657
2021-02-16;"Nitriansky kraj";284;16066;288;16354;NA;126479;572;2021-02-16;74149
2021-02-15;"Nitriansky kraj";122;28636;474;29110;NA;126479;596;2021-02-15;73577
2021-02-14;"Nitriansky kraj";8;49392;315;49707;NA;126479;323;2021-02-14;72981
2021-02-13;"Nitriansky kraj";127;110294;690;110984;NA;126479;817;2021-02-13;72658
2021-02-12;"Nitriansky kraj";162;33405;407;33812;NA;126479;569;2021-02-12;71841
2021-02-11;"Nitriansky kraj";195;12406;270;12676;NA;126479;465;2021-02-11;71272
2021-02-10;"Nitriansky kraj";186;17770;644;18414;NA;126479;830;2021-02-10;70807
2021-02-09;"Nitriansky kraj";260;18530;385;18915;NA;126479;645;2021-02-09;69977
2021-02-08;"Nitriansky kraj";177;37530;569;38099;NA;126479;746;2021-02-08;69332
2021-02-07;"Nitriansky kraj";20;52307;513;52820;NA;126479;533;2021-02-07;68586
2021-02-06;"Nitriansky kraj";129;101439;764;102203;NA;126479;893;2021-02-06;68053
2021-02-05;"Nitriansky kraj";244;26137;491;26628;NA;126479;735;2021-02-05;67160
2021-02-04;"Nitriansky kraj";308;15681;512;16193;NA;126479;820;2021-02-04;66425
2021-02-03;"Nitriansky kraj";191;13459;382;13841;NA;126479;573;2021-02-03;65605
2021-02-02;"Nitriansky kraj";327;17880;382;18262;NA;126479;709;2021-02-02;65032
2021-02-01;"Nitriansky kraj";221;24002;460;24462;NA;126479;681;2021-02-01;64323
2021-01-31;"Nitriansky kraj";9;46215;507;46722;NA;126479;516;2021-01-31;63642
2021-01-30;"Nitriansky kraj";152;99241;1090;100331;NA;126479;1242;2021-01-30;63126
2021-01-29;"Nitriansky kraj";302;22461;477;22938;NA;126479;779;2021-01-29;61884
2021-01-28;"Nitriansky kraj";269;11370;398;11768;NA;126479;667;2021-01-28;61105
2021-01-27;"Nitriansky kraj";235;6758;299;7057;NA;126479;534;2021-01-27;60438
2021-01-26;"Nitriansky kraj";345;16015;454;16469;NA;126479;799;2021-01-26;59904
2021-01-25;"Nitriansky kraj";201;21909;434;22343;NA;126479;635;2021-01-25;59105
2021-01-24;"Nitriansky kraj";12;79041;897;79938;NA;126479;909;2021-01-24;58470
2021-01-23;"Nitriansky kraj";277;97845;1446;99291;NA;126479;1723;2021-01-23;57561
2021-01-22;"Nitriansky kraj";139;35924;619;36543;NA;126479;758;2021-01-22;55838
2021-01-21;"Nitriansky kraj";305;14649;412;15061;NA;126479;717;2021-01-21;55080
2021-01-20;"Nitriansky kraj";326;11991;625;12616;NA;126479;951;2021-01-20;54363
2021-01-19;"Nitriansky kraj";344;11015;633;11648;NA;126479;977;2021-01-19;53412
2021-01-18;"Nitriansky kraj";367;8901;519;9420;NA;126479;886;2021-01-18;52435
2021-01-17;"Nitriansky kraj";97;15061;275;15336;NA;126479;372;2021-01-17;51549
2021-01-16;"Nitriansky kraj";64;36838;679;37517;NA;126479;743;2021-01-16;51177
2021-01-15;"Nitriansky kraj";373;15940;474;16414;NA;126479;847;2021-01-15;50434
2021-01-14;"Nitriansky kraj";627;10577;452;11029;NA;126479;1079;2021-01-14;49587
2021-01-13;"Nitriansky kraj";663;9234;484;9718;NA;126479;1147;2021-01-13;48508
2021-01-12;"Nitriansky kraj";642;8805;545;9350;NA;126479;1187;2021-01-12;47361
2021-01-11;"Nitriansky kraj";422;8347;513;8860;NA;126479;935;2021-01-11;46174
2021-01-10;"Nitriansky kraj";44;19841;730;20571;NA;126479;774;2021-01-10;45239
2021-01-09;"Nitriansky kraj";532;36823;1071;37894;NA;126479;1603;2021-01-09;44465
2021-01-08;"Nitriansky kraj";817;14001;691;14692;NA;126479;1508;2021-01-08;42862
2021-01-07;"Nitriansky kraj";438;10121;795;10916;NA;126479;1233;2021-01-07;41354
2021-01-06;"Nitriansky kraj";259;3192;197;3389;NA;126479;456;2021-01-06;40121
2021-01-05;"Nitriansky kraj";732;8918;1208;10126;NA;126479;1940;2021-01-05;39665
2021-01-04;"Nitriansky kraj";362;8375;1287;9662;NA;126479;1649;2021-01-04;37725
2021-01-03;"Nitriansky kraj";42;84;20;104;NA;126479;62;2021-01-03;36076
2021-01-02;"Nitriansky kraj";249;1090;26;1116;NA;126479;275;2021-01-02;36014
2021-01-01;"Nitriansky kraj";119;781;95;876;NA;126479;214;2021-01-01;35739
2020-12-31;"Nitriansky kraj";786;7646;962;8608;NA;126479;1748;2020-12-31;35525
2020-12-30;"Nitriansky kraj";1094;9619;1165;10784;NA;126479;2259;2020-12-30;33777
2020-12-29;"Nitriansky kraj";607;8028;1245;9273;NA;126479;1852;2020-12-29;31518
2020-12-28;"Nitriansky kraj";83;6804;1220;8024;NA;126479;1303;2020-12-28;29666
2020-12-27;"Nitriansky kraj";22;60;8;68;NA;126479;30;2020-12-27;28363
2020-12-26;"Nitriansky kraj";54;297;56;353;NA;126479;110;2020-12-26;28333
2020-12-25;"Nitriansky kraj";35;60;11;71;NA;126479;46;2020-12-25;28223
2020-12-24;"Nitriansky kraj";514;1861;176;2037;NA;126479;690;2020-12-24;28177
2020-12-23;"Nitriansky kraj";349;14679;782;15461;NA;126479;1131;2020-12-23;27487
2020-12-22;"Nitriansky kraj";673;10623;949;11572;NA;126479;1622;2020-12-22;26356
2020-12-21;"Nitriansky kraj";128;7587;931;8518;NA;126479;1059;2020-12-21;24734
2020-12-20;"Nitriansky kraj";77;50;10;60;NA;126479;87;2020-12-20;23675
2020-12-19;"Nitriansky kraj";262;2259;159;2418;NA;126479;421;2020-12-19;23588
2020-12-18;"Nitriansky kraj";512;7946;518;8464;NA;126479;1030;2020-12-18;23167
2020-12-17;"Nitriansky kraj";586;6519;486;7005;NA;126479;1072;2020-12-17;22137
2020-12-16;"Nitriansky kraj";357;8097;500;8597;NA;126479;857;2020-12-16;21065
2020-12-15;"Nitriansky kraj";461;9084;750;9834;NA;126479;1211;2020-12-15;20208
2020-12-14;"Nitriansky kraj";217;7816;797;8613;NA;126479;1014;2020-12-14;18997
2020-12-13;"Nitriansky kraj";12;69;6;75;NA;126479;18;2020-12-13;17983
2020-12-12;"Nitriansky kraj";341;1832;125;1957;NA;126479;466;2020-12-12;17965
2020-12-11;"Nitriansky kraj";409;5117;384;5501;NA;126479;793;2020-12-11;17499
2020-12-10;"Nitriansky kraj";360;5239;345;5584;NA;126479;705;2020-12-10;16706
2020-12-09;"Nitriansky kraj";362;5494;529;6023;NA;126479;891;2020-12-09;16001
2020-12-08;"Nitriansky kraj";340;8168;548;8716;NA;126479;888;2020-12-08;15110
2020-12-07;"Nitriansky kraj";139;6243;573;6816;NA;126479;712;2020-12-07;14222
2020-12-06;"Nitriansky kraj";15;89;4;93;NA;126479;19;2020-12-06;13510
2020-12-05;"Nitriansky kraj";136;1388;19;1407;NA;126479;155;2020-12-05;13491
2020-12-04;"Nitriansky kraj";232;2884;74;2958;NA;126479;306;2020-12-04;13336
2020-12-03;"Nitriansky kraj";248;2471;110;2581;NA;126479;358;2020-12-03;13030
2020-12-02;"Nitriansky kraj";252;2580;151;2731;NA;126479;403;2020-12-02;12672
2020-12-01;"Nitriansky kraj";331;2891;131;3022;NA;126479;462;2020-12-01;12269
2020-11-30;"Nitriansky kraj";91;4228;188;4416;NA;126479;279;2020-11-30;11807
2020-11-29;"Nitriansky kraj";3;634;42;676;NA;126479;45;2020-11-29;11528
2020-11-28;"Nitriansky kraj";135;892;31;923;NA;126479;166;2020-11-28;11483
2020-11-27;"Nitriansky kraj";177;2069;73;2142;NA;126479;250;2020-11-27;11317
2020-11-26;"Nitriansky kraj";191;2813;80;2893;NA;126479;271;2020-11-26;11067
2020-11-25;"Nitriansky kraj";325;2478;91;2569;NA;126479;416;2020-11-25;10796
2020-11-24;"Nitriansky kraj";147;1641;64;1705;NA;126479;211;2020-11-24;10380
2020-11-23;"Nitriansky kraj";102;9891;212;10103;NA;126479;314;2020-11-23;10169
2020-11-22;"Nitriansky kraj";7;1176;25;1201;NA;126479;32;2020-11-22;9855
2020-11-21;"Nitriansky kraj";86;1083;38;1121;NA;126479;124;2020-11-21;9823
2020-11-20;"Nitriansky kraj";264;4180;103;4283;NA;126479;367;2020-11-20;9699
2020-11-19;"Nitriansky kraj";185;3065;134;3199;NA;126479;319;2020-11-19;9332
2020-11-18;"Nitriansky kraj";188;2214;79;2293;NA;126479;267;2020-11-18;9013
2020-11-17;"Nitriansky kraj";178;596;29;625;NA;126479;207;2020-11-17;8746
2020-11-16;"Nitriansky kraj";139;1877;75;1952;NA;126479;214;2020-11-16;8539
2020-11-15;"Nitriansky kraj";14;180;5;185;NA;126479;19;2020-11-15;8325
2020-11-14;"Nitriansky kraj";114;1131;32;1163;NA;126479;146;2020-11-14;8306
2020-11-13;"Nitriansky kraj";210;936;46;982;NA;126479;256;2020-11-13;8160
2020-11-12;"Nitriansky kraj";256;1195;35;1230;NA;126479;291;2020-11-12;7904
2020-11-11;"Nitriansky kraj";279;1247;22;1269;NA;126479;301;2020-11-11;7613
2020-11-10;"Nitriansky kraj";192;2623;39;2662;NA;126479;231;2020-11-10;7312
2020-11-09;"Nitriansky kraj";128;3136;43;3179;NA;126479;171;2020-11-09;7081
2020-11-08;"Nitriansky kraj";43;1462;32;1494;NA;126479;75;2020-11-08;6910
2020-11-07;"Nitriansky kraj";130;1046;4;1050;NA;126479;134;2020-11-07;6835
2020-11-06;"Nitriansky kraj";210;2264;32;2296;NA;126479;242;2020-11-06;6701
2020-11-05;"Nitriansky kraj";178;313;14;327;NA;126479;192;2020-11-05;6459
2020-11-04;"Nitriansky kraj";211;297;16;313;NA;126479;227;2020-11-04;6267
2020-11-03;"Nitriansky kraj";216;435;25;460;NA;126479;241;2020-11-03;6040
2020-11-02;"Nitriansky kraj";171;4208;46;4254;NA;126479;217;2020-11-02;5799
2020-11-01;"Nitriansky kraj";130;2546;27;2573;NA;126479;157;2020-11-01;5582
2020-10-31;"Nitriansky kraj";261;10466;134;10600;NA;126479;395;2020-10-31;5425
2020-10-30;"Nitriansky kraj";204;2593;42;2635;NA;126479;246;2020-10-30;5030
2020-10-29;"Nitriansky kraj";293;841;39;880;NA;126479;332;2020-10-29;4784
2020-10-28;"Nitriansky kraj";216;608;59;667;NA;126479;275;2020-10-28;4452
2020-10-27;"Nitriansky kraj";296;550;47;597;NA;126479;343;2020-10-27;4177
2020-10-26;"Nitriansky kraj";69;633;56;689;NA;126479;125;2020-10-26;3834
2020-10-25;"Nitriansky kraj";50;62;8;70;NA;126479;58;2020-10-25;3709
2020-10-24;"Nitriansky kraj";169;237;11;248;NA;126479;180;2020-10-24;3651
2020-10-23;"Nitriansky kraj";282;762;41;803;NA;126479;323;2020-10-23;3471
2020-10-22;"Nitriansky kraj";137;444;39;483;NA;126479;176;2020-10-22;3148
2020-10-21;"Nitriansky kraj";146;208;3;211;NA;126479;149;2020-10-21;2972
2020-10-20;"Nitriansky kraj";197;78;6;84;NA;126479;203;2020-10-20;2823
2020-10-19;"Nitriansky kraj";148;79;1;80;NA;126479;149;2020-10-19;2620
2020-10-18;"Nitriansky kraj";22;0;0;0;NA;126479;22;2020-10-18;2471
2020-10-17;"Nitriansky kraj";67;0;0;0;NA;126479;67;2020-10-17;2449
2020-10-16;"Nitriansky kraj";133;28;3;31;NA;126479;136;2020-10-16;2382
2020-10-15;"Nitriansky kraj";106;31;2;33;NA;126479;108;2020-10-15;2246
2020-10-14;"Nitriansky kraj";80;22;4;26;NA;126479;84;2020-10-14;2138
2020-10-13;"Nitriansky kraj";101;82;2;84;NA;126479;103;2020-10-13;2054
2020-10-12;"Nitriansky kraj";36;0;0;0;NA;126479;36;2020-10-12;1951
2020-10-11;"Nitriansky kraj";8;0;0;0;NA;126479;8;2020-10-11;1915
2020-10-10;"Nitriansky kraj";107;0;0;0;NA;126479;107;2020-10-10;1907
2020-10-09;"Nitriansky kraj";120;0;0;0;NA;126479;120;2020-10-09;1800
2020-10-08;"Nitriansky kraj";132;0;0;0;NA;126479;132;2020-10-08;1680
2020-10-07;"Nitriansky kraj";81;0;0;0;NA;126479;81;2020-10-07;1548
2020-10-06;"Nitriansky kraj";48;0;0;0;NA;126479;48;2020-10-06;1467
2020-10-05;"Nitriansky kraj";20;0;0;0;NA;126479;20;2020-10-05;1419
2020-10-04;"Nitriansky kraj";17;0;0;0;NA;126479;17;2020-10-04;1399
2020-10-03;"Nitriansky kraj";96;0;0;0;NA;126479;96;2020-10-03;1382
2020-10-02;"Nitriansky kraj";108;0;0;0;NA;126479;108;2020-10-02;1286
2020-10-01;"Nitriansky kraj";95;0;0;0;NA;126479;95;2020-10-01;1178
2020-09-30;"Nitriansky kraj";100;0;0;0;NA;126479;100;2020-09-30;1083
2020-09-29;"Nitriansky kraj";50;0;0;0;NA;126479;50;2020-09-29;983
2020-09-28;"Nitriansky kraj";22;0;0;0;NA;126479;22;2020-09-28;933
2020-09-27;"Nitriansky kraj";16;0;0;0;NA;126479;16;2020-09-27;911
2020-09-26;"Nitriansky kraj";64;0;0;0;NA;126479;64;2020-09-26;895
2020-09-25;"Nitriansky kraj";90;0;0;0;NA;126479;90;2020-09-25;831
2020-09-24;"Nitriansky kraj";51;0;0;0;NA;126479;51;2020-09-24;741
2020-09-23;"Nitriansky kraj";70;0;0;0;NA;126479;70;2020-09-23;690
2020-09-22;"Nitriansky kraj";18;0;0;0;NA;126479;18;2020-09-22;620
2020-09-21;"Nitriansky kraj";10;0;0;0;NA;126479;10;2020-09-21;602
2020-09-20;"Nitriansky kraj";4;0;0;0;NA;126479;4;2020-09-20;592
2020-09-19;"Nitriansky kraj";14;0;0;0;NA;126479;14;2020-09-19;588
2020-09-18;"Nitriansky kraj";19;0;0;0;NA;126479;19;2020-09-18;574
2020-09-17;"Nitriansky kraj";30;0;0;0;NA;126479;30;2020-09-17;555
2020-09-16;"Nitriansky kraj";6;0;0;0;NA;126479;6;2020-09-16;525
2020-09-15;"Nitriansky kraj";19;0;0;0;NA;126479;19;2020-09-15;519
2020-09-14;"Nitriansky kraj";28;0;0;0;NA;126479;28;2020-09-14;500
2020-09-13;"Nitriansky kraj";3;0;0;0;NA;126479;3;2020-09-13;472
2020-09-12;"Nitriansky kraj";12;0;0;0;NA;126479;12;2020-09-12;469
2020-09-11;"Nitriansky kraj";23;0;0;0;NA;126479;23;2020-09-11;457
2020-09-10;"Nitriansky kraj";29;0;0;0;NA;126479;29;2020-09-10;434
2020-09-09;"Nitriansky kraj";19;0;0;0;NA;126479;19;2020-09-09;405
2020-09-08;"Nitriansky kraj";17;0;0;0;NA;126479;17;2020-09-08;386
2020-09-07;"Nitriansky kraj";17;0;0;0;NA;126479;17;2020-09-07;369
2020-09-06;"Nitriansky kraj";0;0;0;0;NA;126479;0;2020-09-06;352
2020-09-05;"Nitriansky kraj";22;0;0;0;NA;126479;22;2020-09-05;352
2020-09-04;"Nitriansky kraj";34;0;0;0;NA;126479;34;2020-09-04;330
2020-09-03;"Nitriansky kraj";15;0;0;0;NA;126479;15;2020-09-03;296
2020-09-02;"Nitriansky kraj";15;0;0;0;NA;126479;15;2020-09-02;281
2020-09-01;"Nitriansky kraj";2;0;0;0;NA;126479;2;2020-09-01;266
2020-08-31;"Nitriansky kraj";12;0;0;0;NA;126479;12;2020-08-31;264
2020-08-30;"Nitriansky kraj";1;0;0;0;NA;126479;1;2020-08-30;252
2020-08-29;"Nitriansky kraj";7;46;0;46;NA;126479;7;2020-08-29;251
2020-08-28;"Nitriansky kraj";12;0;0;0;NA;126479;12;2020-08-28;244
2020-08-27;"Nitriansky kraj";12;0;0;0;NA;126479;12;2020-08-27;232
2020-08-26;"Nitriansky kraj";4;0;0;0;NA;126479;4;2020-08-26;220
2020-08-25;"Nitriansky kraj";8;0;0;0;NA;126479;8;2020-08-25;216
2020-08-24;"Nitriansky kraj";1;0;0;0;NA;126479;1;2020-08-24;208
2020-08-23;"Nitriansky kraj";1;0;0;0;NA;126479;1;2020-08-23;207
2020-08-22;"Nitriansky kraj";2;0;0;0;NA;126479;2;2020-08-22;206
2020-08-21;"Nitriansky kraj";0;0;0;0;NA;126479;0;2020-08-21;204
2020-08-20;"Nitriansky kraj";7;0;0;0;NA;126479;7;2020-08-20;204
2020-08-19;"Nitriansky kraj";1;0;0;0;NA;126479;1;2020-08-19;197
2020-08-18;"Nitriansky kraj";2;0;0;0;NA;126479;2;2020-08-18;196
2020-08-17;"Nitriansky kraj";1;0;0;0;NA;126479;1;2020-08-17;194
2020-08-16;"Nitriansky kraj";0;0;0;0;NA;126479;0;2020-08-16;193
2020-08-15;"Nitriansky kraj";2;0;0;0;NA;126479;2;2020-08-15;193
2020-08-14;"Nitriansky kraj";1;0;0;0;NA;126479;1;2020-08-14;191
2020-08-13;"Nitriansky kraj";4;0;0;0;NA;126479;4;2020-08-13;190
2020-08-12;"Nitriansky kraj";0;0;0;0;NA;126479;0;2020-08-12;186
2020-08-11;"Nitriansky kraj";1;0;0;0;NA;126479;1;2020-08-11;186
2020-08-10;"Nitriansky kraj";0;0;0;0;NA;126479;0;2020-08-10;185
2020-08-09;"Nitriansky kraj";0;0;0;0;NA;126479;0;2020-08-09;185
2020-08-08;"Nitriansky kraj";0;0;0;0;NA;126479;0;2020-08-08;185
2020-08-07;"Nitriansky kraj";4;0;0;0;NA;126479;4;2020-08-07;185
2020-08-06;"Nitriansky kraj";4;0;0;0;NA;126479;4;2020-08-06;181
2020-08-05;"Nitriansky kraj";0;0;0;0;NA;126479;0;2020-08-05;177
2020-08-04;"Nitriansky kraj";7;0;0;0;NA;126479;7;2020-08-04;177
2020-08-03;"Nitriansky kraj";0;0;0;0;NA;126479;0;2020-08-03;170
2020-08-02;"Nitriansky kraj";0;0;0;0;NA;126479;0;2020-08-02;170
2020-08-01;"Nitriansky kraj";0;0;0;0;NA;126479;0;2020-08-01;170
2020-07-31;"Nitriansky kraj";0;0;0;0;NA;126479;0;2020-07-31;170
2020-07-30;"Nitriansky kraj";0;0;0;0;NA;126479;0;2020-07-30;170
2020-07-29;"Nitriansky kraj";0;0;0;0;NA;126479;0;2020-07-29;170
2020-07-28;"Nitriansky kraj";0;0;0;0;NA;126479;0;2020-07-28;170
2020-07-27;"Nitriansky kraj";0;0;0;0;NA;126479;0;2020-07-27;170
2020-07-26;"Nitriansky kraj";0;0;0;0;NA;126479;0;2020-07-26;170
2020-07-25;"Nitriansky kraj";0;0;0;0;NA;126479;0;2020-07-25;170
2020-07-24;"Nitriansky kraj";1;0;0;0;NA;126479;1;2020-07-24;170
2020-07-23;"Nitriansky kraj";3;0;0;0;NA;126479;3;2020-07-23;169
2020-07-22;"Nitriansky kraj";2;0;0;0;NA;126479;2;2020-07-22;166
2020-07-21;"Nitriansky kraj";14;0;0;0;NA;126479;14;2020-07-21;164
2020-07-20;"Nitriansky kraj";11;0;0;0;NA;126479;11;2020-07-20;150
2020-07-19;"Nitriansky kraj";0;0;0;0;NA;126479;0;2020-07-19;139
2020-07-18;"Nitriansky kraj";0;0;0;0;NA;126479;0;2020-07-18;139
2020-07-17;"Nitriansky kraj";0;0;0;0;NA;126479;0;2020-07-17;139
2020-07-16;"Nitriansky kraj";4;0;0;0;NA;126479;4;2020-07-16;139
2020-07-15;"Nitriansky kraj";5;0;0;0;NA;126479;5;2020-07-15;135
2020-07-14;"Nitriansky kraj";0;0;0;0;NA;126479;0;2020-07-14;130
2020-07-13;"Nitriansky kraj";0;0;0;0;NA;126479;0;2020-07-13;130
2020-07-12;"Nitriansky kraj";0;0;0;0;NA;126479;0;2020-07-12;130
2020-07-11;"Nitriansky kraj";0;0;0;0;NA;126479;0;2020-07-11;130
2020-07-10;"Nitriansky kraj";0;0;0;0;NA;126479;0;2020-07-10;130
2020-07-09;"Nitriansky kraj";1;0;0;0;NA;126479;1;2020-07-09;130
2020-07-08;"Nitriansky kraj";2;0;0;0;NA;126479;2;2020-07-08;129
2020-07-07;"Nitriansky kraj";0;0;0;0;NA;126479;0;2020-07-07;127
2020-07-06;"Nitriansky kraj";0;0;0;0;NA;126479;0;2020-07-06;127
2020-07-05;"Nitriansky kraj";0;0;0;0;NA;126479;0;2020-07-05;127
2020-07-04;"Nitriansky kraj";0;0;0;0;NA;126479;0;2020-07-04;127
2020-07-03;"Nitriansky kraj";0;0;0;0;NA;126479;0;2020-07-03;127
2020-07-02;"Nitriansky kraj";0;0;0;0;NA;126479;0;2020-07-02;127
2020-07-01;"Nitriansky kraj";3;0;0;0;NA;126479;3;2020-07-01;127
2020-06-30;"Nitriansky kraj";0;0;0;0;NA;126479;0;2020-06-30;124
2020-06-29;"Nitriansky kraj";0;0;0;0;NA;126479;0;2020-06-29;124
2020-06-28;"Nitriansky kraj";0;0;0;0;NA;126479;0;2020-06-28;124
2020-06-27;"Nitriansky kraj";0;0;0;0;NA;126479;0;2020-06-27;124
2020-06-26;"Nitriansky kraj";0;0;0;0;NA;126479;0;2020-06-26;124
2020-06-25;"Nitriansky kraj";0;0;0;0;NA;126479;0;2020-06-25;124
2020-06-24;"Nitriansky kraj";1;0;0;0;NA;126479;1;2020-06-24;124
2020-06-23;"Nitriansky kraj";0;0;0;0;NA;126479;0;2020-06-23;123
2020-06-22;"Nitriansky kraj";0;0;0;0;NA;126479;0;2020-06-22;123
2020-06-21;"Nitriansky kraj";0;0;0;0;NA;126479;0;2020-06-21;123
2020-06-20;"Nitriansky kraj";0;0;0;0;NA;126479;0;2020-06-20;123
2020-06-19;"Nitriansky kraj";0;0;0;0;NA;126479;0;2020-06-19;123
2020-06-18;"Nitriansky kraj";0;0;0;0;NA;126479;0;2020-06-18;123
2020-06-17;"Nitriansky kraj";0;0;0;0;NA;126479;0;2020-06-17;123
2020-06-16;"Nitriansky kraj";0;0;0;0;NA;126479;0;2020-06-16;123
2020-06-14;"Nitriansky kraj";0;0;0;0;NA;126479;0;2020-06-14;123
2020-06-13;"Nitriansky kraj";0;0;0;0;NA;126479;0;2020-06-13;123
2020-06-12;"Nitriansky kraj";0;0;0;0;NA;126479;0;2020-06-12;123
2020-06-11;"Nitriansky kraj";0;0;0;0;NA;126479;0;2020-06-11;123
2020-06-10;"Nitriansky kraj";1;0;0;0;NA;126479;1;2020-06-10;123
2020-06-09;"Nitriansky kraj";1;0;0;0;NA;126479;1;2020-06-09;122
2020-06-08;"Nitriansky kraj";0;0;0;0;NA;126479;0;2020-06-08;121
2020-06-07;"Nitriansky kraj";0;0;0;0;NA;126479;0;2020-06-07;121
2020-06-05;"Nitriansky kraj";0;0;0;0;NA;126479;0;2020-06-05;121
2020-06-03;"Nitriansky kraj";0;0;0;0;NA;126479;0;2020-06-03;121
2020-06-02;"Nitriansky kraj";1;0;0;0;NA;126479;1;2020-06-02;121
2020-05-31;"Nitriansky kraj";0;0;0;0;NA;126479;0;2020-05-31;120
2020-05-29;"Nitriansky kraj";0;0;0;0;NA;126479;0;2020-05-29;120
2020-05-27;"Nitriansky kraj";0;0;0;0;NA;126479;0;2020-05-27;120
2020-05-26;"Nitriansky kraj";0;0;0;0;NA;126479;0;2020-05-26;120
2020-05-25;"Nitriansky kraj";0;0;0;0;NA;126479;0;2020-05-25;120
2020-05-24;"Nitriansky kraj";2;0;0;0;NA;126479;2;2020-05-24;120
2020-05-23;"Nitriansky kraj";0;0;0;0;NA;126479;0;2020-05-23;118
2020-05-22;"Nitriansky kraj";1;0;0;0;NA;126479;1;2020-05-22;118
2020-05-21;"Nitriansky kraj";0;0;0;0;NA;126479;0;2020-05-21;117
2020-05-20;"Nitriansky kraj";0;0;0;0;NA;126479;0;2020-05-20;117
2020-05-19;"Nitriansky kraj";0;0;0;0;NA;126479;0;2020-05-19;117
2020-05-17;"Nitriansky kraj";0;0;0;0;NA;126479;0;2020-05-17;117
2020-05-16;"Nitriansky kraj";0;0;0;0;NA;126479;0;2020-05-16;117
2020-05-15;"Nitriansky kraj";1;0;0;0;NA;126479;1;2020-05-15;117
2020-05-14;"Nitriansky kraj";0;0;0;0;NA;126479;0;2020-05-14;116
2020-05-13;"Nitriansky kraj";0;0;0;0;NA;126479;0;2020-05-13;116
2020-05-12;"Nitriansky kraj";0;0;0;0;NA;126479;0;2020-05-12;116
2020-05-11;"Nitriansky kraj";2;0;0;0;NA;126479;2;2020-05-11;116
2020-05-09;"Nitriansky kraj";0;0;0;0;NA;126479;0;2020-05-09;114
2020-05-07;"Nitriansky kraj";1;0;0;0;NA;126479;1;2020-05-07;114
2020-05-06;"Nitriansky kraj";9;0;0;0;NA;126479;9;2020-05-06;113
2020-05-05;"Nitriansky kraj";0;0;0;0;NA;126479;0;2020-05-05;104
2020-05-04;"Nitriansky kraj";5;0;0;0;NA;126479;5;2020-05-04;104
2020-05-03;"Nitriansky kraj";2;0;0;0;NA;126479;2;2020-05-03;99
2020-05-02;"Nitriansky kraj";0;0;0;0;NA;126479;0;2020-05-02;97
2020-05-01;"Nitriansky kraj";1;0;0;0;NA;126479;1;2020-05-01;97
2020-04-30;"Nitriansky kraj";0;0;0;0;NA;126479;0;2020-04-30;96
2020-04-29;"Nitriansky kraj";0;0;0;0;NA;126479;0;2020-04-29;96
2020-04-28;"Nitriansky kraj";1;0;0;0;NA;126479;1;2020-04-28;96
2020-04-27;"Nitriansky kraj";0;0;0;0;NA;126479;0;2020-04-27;95
2020-04-26;"Nitriansky kraj";0;0;0;0;NA;126479;0;2020-04-26;95
2020-04-25;"Nitriansky kraj";0;0;0;0;NA;126479;0;2020-04-25;95
2020-04-24;"Nitriansky kraj";0;0;0;0;NA;126479;0;2020-04-24;95
2020-04-23;"Nitriansky kraj";3;0;0;0;NA;126479;3;2020-04-23;95
2020-04-22;"Nitriansky kraj";16;0;0;0;NA;126479;16;2020-04-22;92
2020-04-21;"Nitriansky kraj";6;0;0;0;NA;126479;6;2020-04-21;76
2020-04-20;"Nitriansky kraj";5;0;0;0;NA;126479;5;2020-04-20;70
2020-04-19;"Nitriansky kraj";0;0;0;0;NA;126479;0;2020-04-19;65
2020-04-18;"Nitriansky kraj";0;0;0;0;NA;126479;0;2020-04-18;65
2020-04-17;"Nitriansky kraj";7;0;0;0;NA;126479;7;2020-04-17;65
2020-04-16;"Nitriansky kraj";0;0;0;0;NA;126479;0;2020-04-16;58
2020-04-15;"Nitriansky kraj";6;0;0;0;NA;126479;6;2020-04-15;58
2020-04-14;"Nitriansky kraj";2;0;0;0;NA;126479;2;2020-04-14;52
2020-04-13;"Nitriansky kraj";1;0;0;0;NA;126479;1;2020-04-13;50
2020-04-12;"Nitriansky kraj";3;0;0;0;NA;126479;3;2020-04-12;49
2020-04-11;"Nitriansky kraj";1;0;0;0;NA;126479;1;2020-04-11;46
2020-04-10;"Nitriansky kraj";1;0;0;0;NA;126479;1;2020-04-10;45
2020-04-09;"Nitriansky kraj";0;0;0;0;NA;126479;0;2020-04-09;44
2020-04-08;"Nitriansky kraj";2;0;0;0;NA;126479;2;2020-04-08;44
2020-04-07;"Nitriansky kraj";3;0;0;0;NA;126479;3;2020-04-07;42
2020-04-06;"Nitriansky kraj";4;0;0;0;NA;126479;4;2020-04-06;39
2020-04-05;"Nitriansky kraj";5;0;0;0;NA;126479;5;2020-04-05;35
2020-04-04;"Nitriansky kraj";0;0;0;0;NA;126479;0;2020-04-04;30
2020-04-03;"Nitriansky kraj";0;0;0;0;NA;126479;0;2020-04-03;30
2020-04-02;"Nitriansky kraj";1;0;0;0;NA;126479;1;2020-04-02;30
2020-04-01;"Nitriansky kraj";0;0;0;0;NA;126479;0;2020-04-01;29
2020-03-31;"Nitriansky kraj";3;0;0;0;NA;126479;3;2020-03-31;29
2020-03-30;"Nitriansky kraj";3;0;0;0;NA;126479;3;2020-03-30;26
2020-03-29;"Nitriansky kraj";3;0;0;0;NA;126479;3;2020-03-29;23
2020-03-28;"Nitriansky kraj";1;0;0;0;NA;126479;1;2020-03-28;20
2020-03-27;"Nitriansky kraj";1;0;0;0;NA;126479;1;2020-03-27;19
2020-03-26;"Nitriansky kraj";1;0;0;0;NA;126479;1;2020-03-26;18
2020-03-25;"Nitriansky kraj";1;0;0;0;NA;126479;1;2020-03-25;17
2020-03-24;"Nitriansky kraj";0;0;0;0;NA;126479;0;2020-03-24;16
2020-03-23;"Nitriansky kraj";2;0;0;0;NA;126479;2;2020-03-23;16
2020-03-22;"Nitriansky kraj";2;0;0;0;NA;126479;2;2020-03-22;14
2020-03-21;"Nitriansky kraj";2;0;0;0;NA;126479;2;2020-03-21;12
2020-03-20;"Nitriansky kraj";1;0;0;0;NA;126479;1;2020-03-20;10
2020-03-19;"Nitriansky kraj";1;0;0;0;NA;126479;1;2020-03-19;9
2020-03-18;"Nitriansky kraj";2;0;0;0;NA;126479;2;2020-03-18;8
2020-03-17;"Nitriansky kraj";1;0;0;0;NA;126479;1;2020-03-17;6
2020-03-16;"Nitriansky kraj";0;0;0;0;NA;126479;0;2020-03-16;5
2020-03-15;"Nitriansky kraj";4;0;0;0;NA;126479;4;2020-03-15;5
2020-03-14;"Nitriansky kraj";1;0;0;0;NA;126479;1;2020-03-14;1
2020-03-13;"Nitriansky kraj";0;0;0;0;NA;126479;0;2020-03-13;0
2020-03-12;"Nitriansky kraj";0;0;0;0;NA;126479;0;2020-03-12;0
2020-03-11;"Nitriansky kraj";0;0;0;0;NA;126479;0;2020-03-11;0
2020-03-09;"Nitriansky kraj";0;0;0;0;NA;126479;0;2020-03-09;0
2020-03-08;"Nitriansky kraj";0;0;0;0;NA;126479;0;2020-03-08;0
2020-03-07;"Nitriansky kraj";0;0;0;0;NA;126479;0;2020-03-07;0
2020-03-06;"Nitriansky kraj";0;0;0;0;NA;126479;0;2020-03-06;0
2021-12-02;"Prešovský kraj";2255;6;0;6;118972;189006;2255;2021-12-02;189006
2021-12-01;"Prešovský kraj";826;3290;154;3444;NA;189006;980;2021-12-01;186751
2021-11-30;"Prešovský kraj";1123;6117;225;6342;NA;189006;1348;2021-11-30;185771
2021-11-29;"Prešovský kraj";583;11066;445;11511;NA;189006;1028;2021-11-29;184423
2021-11-28;"Prešovský kraj";919;5540;220;5760;NA;189006;1139;2021-11-28;183395
2021-11-27;"Prešovský kraj";884;2891;209;3100;NA;189006;1093;2021-11-27;182256
2021-11-26;"Prešovský kraj";1311;5775;320;6095;NA;189006;1631;2021-11-26;181163
2021-11-25;"Prešovský kraj";1285;4991;305;5296;NA;189006;1590;2021-11-25;179532
2021-11-24;"Prešovský kraj";1209;6036;348;6384;NA;189006;1557;2021-11-24;177942
2021-11-23;"Prešovský kraj";1099;6564;310;6874;NA;189006;1409;2021-11-23;176385
2021-11-22;"Prešovský kraj";905;8105;524;8629;NA;189006;1429;2021-11-22;174976
2021-11-21;"Prešovský kraj";950;3662;308;3970;NA;189006;1258;2021-11-21;173547
2021-11-20;"Prešovský kraj";1372;2150;218;2368;NA;189006;1590;2021-11-20;172289
2021-11-19;"Prešovský kraj";1629;5827;449;6276;NA;189006;2078;2021-11-19;170699
2021-11-18;"Prešovský kraj";823;6625;512;7137;NA;189006;1335;2021-11-18;168621
2021-11-17;"Prešovský kraj";1648;1300;141;1441;NA;189006;1789;2021-11-17;167286
2021-11-16;"Prešovský kraj";1346;5462;398;5860;NA;189006;1744;2021-11-16;165497
2021-11-15;"Prešovský kraj";897;7752;577;8329;NA;189006;1474;2021-11-15;163753
2021-11-14;"Prešovský kraj";603;3168;311;3479;NA;189006;914;2021-11-14;162279
2021-11-13;"Prešovský kraj";1255;2061;262;2323;NA;189006;1517;2021-11-13;161365
2021-11-12;"Prešovský kraj";1358;5216;370;5586;NA;189006;1728;2021-11-12;159848
2021-11-11;"Prešovský kraj";1218;5081;438;5519;NA;189006;1656;2021-11-11;158120
2021-11-10;"Prešovský kraj";1278;4942;378;5320;NA;189006;1656;2021-11-10;156464
2021-11-09;"Prešovský kraj";1038;5422;407;5829;NA;189006;1445;2021-11-09;154808
2021-11-08;"Prešovský kraj";1068;6952;574;7526;NA;189006;1642;2021-11-08;153363
2021-11-07;"Prešovský kraj";421;2500;242;2742;NA;189006;663;2021-11-07;151721
2021-11-06;"Prešovský kraj";1389;1896;234;2130;NA;189006;1623;2021-11-06;151058
2021-11-05;"Prešovský kraj";1080;4963;367;5330;NA;189006;1447;2021-11-05;149435
2021-11-04;"Prešovský kraj";1743;5143;322;5465;NA;189006;2065;2021-11-04;147988
2021-11-03;"Prešovský kraj";1326;5325;387;5712;NA;189006;1713;2021-11-03;145923
2021-11-02;"Prešovský kraj";1002;7435;536;7971;NA;189006;1538;2021-11-02;144210
2021-11-01;"Prešovský kraj";347;1395;131;1526;NA;189006;478;2021-11-01;142672
2021-10-31;"Prešovský kraj";447;2028;210;2238;NA;189006;657;2021-10-31;142194
2021-10-30;"Prešovský kraj";1148;1915;183;2098;NA;189006;1331;2021-10-30;141537
2021-10-29;"Prešovský kraj";1360;4439;253;4692;NA;189006;1613;2021-10-29;140206
2021-10-28;"Prešovský kraj";960;4491;300;4791;NA;189006;1260;2021-10-28;138593
2021-10-27;"Prešovský kraj";1444;4314;219;4533;NA;189006;1663;2021-10-27;137333
2021-10-26;"Prešovský kraj";940;5112;217;5329;NA;189006;1157;2021-10-26;135670
2021-10-25;"Prešovský kraj";673;6071;348;6419;NA;189006;1021;2021-10-25;134513
2021-10-24;"Prešovský kraj";110;2174;149;2323;NA;189006;259;2021-10-24;133492
2021-10-23;"Prešovský kraj";1145;1923;141;2064;NA;189006;1286;2021-10-23;133233
2021-10-22;"Prešovský kraj";792;4863;177;5040;NA;189006;969;2021-10-22;131947
2021-10-21;"Prešovský kraj";901;4724;191;4915;NA;189006;1092;2021-10-21;130978
2021-10-20;"Prešovský kraj";833;4193;195;4388;NA;189006;1028;2021-10-20;129886
2021-10-19;"Prešovský kraj";830;4720;175;4895;NA;189006;1005;2021-10-19;128858
2021-10-18;"Prešovský kraj";454;5743;240;5983;NA;189006;694;2021-10-18;127853
2021-10-17;"Prešovský kraj";181;2422;131;2553;NA;189006;312;2021-10-17;127159
2021-10-16;"Prešovský kraj";561;1912;94;2006;NA;189006;655;2021-10-16;126847
2021-10-15;"Prešovský kraj";533;4725;107;4832;NA;189006;640;2021-10-15;126192
2021-10-14;"Prešovský kraj";506;3928;85;4013;NA;189006;591;2021-10-14;125552
2021-10-13;"Prešovský kraj";549;3788;98;3886;NA;189006;647;2021-10-13;124961
2021-10-12;"Prešovský kraj";520;3961;101;4062;NA;189006;621;2021-10-12;124314
2021-10-11;"Prešovský kraj";433;5396;131;5527;NA;189006;564;2021-10-11;123693
2021-10-10;"Prešovský kraj";78;2087;63;2150;NA;189006;141;2021-10-10;123129
2021-10-09;"Prešovský kraj";311;2063;47;2110;NA;189006;358;2021-10-09;122988
2021-10-08;"Prešovský kraj";636;4909;94;5003;NA;189006;730;2021-10-08;122630
2021-10-07;"Prešovský kraj";487;3919;101;4020;NA;189006;588;2021-10-07;121900
2021-10-06;"Prešovský kraj";296;3838;104;3942;NA;189006;400;2021-10-06;121312
2021-10-05;"Prešovský kraj";430;4143;90;4233;NA;189006;520;2021-10-05;120912
2021-10-04;"Prešovský kraj";353;5564;125;5689;NA;189006;478;2021-10-04;120392
2021-10-03;"Prešovský kraj";19;2309;47;2356;NA;189006;66;2021-10-03;119914
2021-10-02;"Prešovský kraj";269;2234;58;2292;NA;189006;327;2021-10-02;119848
2021-10-01;"Prešovský kraj";325;4994;63;5057;NA;189006;388;2021-10-01;119521
2021-09-30;"Prešovský kraj";265;4029;83;4112;NA;189006;348;2021-09-30;119133
2021-09-29;"Prešovský kraj";381;3821;55;3876;NA;189006;436;2021-09-29;118785
2021-09-28;"Prešovský kraj";312;4705;69;4774;NA;189006;381;2021-09-28;118349
2021-09-27;"Prešovský kraj";257;5048;104;5152;NA;189006;361;2021-09-27;117968
2021-09-26;"Prešovský kraj";8;2411;67;2478;NA;189006;75;2021-09-26;117607
2021-09-25;"Prešovský kraj";134;2520;46;2566;NA;189006;180;2021-09-25;117532
2021-09-24;"Prešovský kraj";297;4811;61;4872;NA;189006;358;2021-09-24;117352
2021-09-23;"Prešovský kraj";109;4089;45;4134;NA;189006;154;2021-09-23;116994
2021-09-22;"Prešovský kraj";177;3825;41;3866;NA;189006;218;2021-09-22;116840
2021-09-21;"Prešovský kraj";219;5052;66;5118;NA;189006;285;2021-09-21;116622
2021-09-20;"Prešovský kraj";180;5175;68;5243;NA;189006;248;2021-09-20;116337
2021-09-19;"Prešovský kraj";7;2707;30;2737;NA;189006;37;2021-09-19;116089
2021-09-18;"Prešovský kraj";169;2397;37;2434;NA;189006;206;2021-09-18;116052
2021-09-17;"Prešovský kraj";157;4393;52;4445;NA;189006;209;2021-09-17;115846
2021-09-16;"Prešovský kraj";146;4361;71;4432;NA;189006;217;2021-09-16;115637
2021-09-15;"Prešovský kraj";68;695;19;714;NA;189006;87;2021-09-15;115420
2021-09-14;"Prešovský kraj";133;3364;38;3402;NA;189006;171;2021-09-14;115333
2021-09-13;"Prešovský kraj";105;4213;37;4250;NA;189006;142;2021-09-13;115162
2021-09-12;"Prešovský kraj";4;1772;29;1801;NA;189006;33;2021-09-12;115020
2021-09-11;"Prešovský kraj";65;1986;24;2010;NA;189006;89;2021-09-11;114987
2021-09-10;"Prešovský kraj";105;3241;30;3271;NA;189006;135;2021-09-10;114898
2021-09-09;"Prešovský kraj";29;3090;27;3117;NA;189006;56;2021-09-09;114763
2021-09-08;"Prešovský kraj";73;2444;20;2464;NA;189006;93;2021-09-08;114707
2021-09-07;"Prešovský kraj";82;2441;24;2465;NA;189006;106;2021-09-07;114614
2021-09-06;"Prešovský kraj";61;3269;20;3289;NA;189006;81;2021-09-06;114508
2021-09-05;"Prešovský kraj";5;1338;11;1349;NA;189006;16;2021-09-05;114427
2021-09-04;"Prešovský kraj";27;1864;14;1878;NA;189006;41;2021-09-04;114411
2021-09-03;"Prešovský kraj";39;2976;15;2991;NA;189006;54;2021-09-03;114370
2021-09-02;"Prešovský kraj";39;2558;20;2578;NA;189006;59;2021-09-02;114316
2021-09-01;"Prešovský kraj";14;575;6;581;NA;189006;20;2021-09-01;114257
2021-08-31;"Prešovský kraj";47;2436;13;2449;NA;189006;60;2021-08-31;114237
2021-08-30;"Prešovský kraj";23;2827;19;2846;NA;189006;42;2021-08-30;114177
2021-08-29;"Prešovský kraj";3;781;1;782;NA;189006;4;2021-08-29;114135
2021-08-28;"Prešovský kraj";5;2101;8;2109;NA;189006;13;2021-08-28;114131
2021-08-27;"Prešovský kraj";32;3084;8;3092;NA;189006;40;2021-08-27;114118
2021-08-26;"Prešovský kraj";13;2094;8;2102;NA;189006;21;2021-08-26;114078
2021-08-25;"Prešovský kraj";18;1947;4;1951;NA;189006;22;2021-08-25;114057
2021-08-24;"Prešovský kraj";10;2138;5;2143;NA;189006;15;2021-08-24;114035
2021-08-23;"Prešovský kraj";16;2576;6;2582;NA;189006;22;2021-08-23;114020
2021-08-22;"Prešovský kraj";0;1440;6;1446;NA;189006;6;2021-08-22;113998
2021-08-21;"Prešovský kraj";28;2018;4;2022;NA;189006;32;2021-08-21;113992
2021-08-20;"Prešovský kraj";15;2906;7;2913;NA;189006;22;2021-08-20;113960
2021-08-19;"Prešovský kraj";22;2242;8;2250;NA;189006;30;2021-08-19;113938
2021-08-18;"Prešovský kraj";6;1752;11;1763;NA;189006;17;2021-08-18;113908
2021-08-17;"Prešovský kraj";29;1829;6;1835;NA;189006;35;2021-08-17;113891
2021-08-16;"Prešovský kraj";11;2524;7;2531;NA;189006;18;2021-08-16;113856
2021-08-15;"Prešovský kraj";0;896;2;898;NA;189006;2;2021-08-15;113838
2021-08-14;"Prešovský kraj";14;1662;1;1663;NA;189006;15;2021-08-14;113836
2021-08-13;"Prešovský kraj";24;1646;12;1658;NA;189006;36;2021-08-13;113821
2021-08-12;"Prešovský kraj";9;1752;3;1755;NA;189006;12;2021-08-12;113785
2021-08-11;"Prešovský kraj";15;1193;3;1196;NA;189006;18;2021-08-11;113773
2021-08-10;"Prešovský kraj";10;1102;4;1106;NA;189006;14;2021-08-10;113755
2021-08-09;"Prešovský kraj";13;2156;4;2160;NA;189006;17;2021-08-09;113741
2021-08-08;"Prešovský kraj";2;675;2;677;NA;189006;4;2021-08-08;113724
2021-08-07;"Prešovský kraj";5;1114;3;1117;NA;189006;8;2021-08-07;113720
2021-08-06;"Prešovský kraj";9;1459;4;1463;NA;189006;13;2021-08-06;113712
2021-08-05;"Prešovský kraj";9;1370;2;1372;NA;189006;11;2021-08-05;113699
2021-08-04;"Prešovský kraj";6;1007;1;1008;NA;189006;7;2021-08-04;113688
2021-08-03;"Prešovský kraj";8;976;1;977;NA;189006;9;2021-08-03;113681
2021-08-02;"Prešovský kraj";5;1477;6;1483;NA;189006;11;2021-08-02;113672
2021-08-01;"Prešovský kraj";0;738;2;740;NA;189006;2;2021-08-01;113661
2021-07-31;"Prešovský kraj";20;1080;0;1080;NA;189006;20;2021-07-31;113659
2021-07-30;"Prešovský kraj";2;1518;1;1519;NA;189006;3;2021-07-30;113639
2021-07-29;"Prešovský kraj";6;1302;1;1303;NA;189006;7;2021-07-29;113636
2021-07-28;"Prešovský kraj";6;1106;1;1107;NA;189006;7;2021-07-28;113629
2021-07-27;"Prešovský kraj";5;1140;2;1142;NA;189006;7;2021-07-27;113622
2021-07-26;"Prešovský kraj";12;1583;1;1584;NA;189006;13;2021-07-26;113615
2021-07-25;"Prešovský kraj";0;687;1;688;NA;189006;1;2021-07-25;113602
2021-07-24;"Prešovský kraj";8;1040;0;1040;NA;189006;8;2021-07-24;113601
2021-07-23;"Prešovský kraj";8;1608;1;1609;NA;189006;9;2021-07-23;113593
2021-07-22;"Prešovský kraj";13;1431;10;1441;NA;189006;23;2021-07-22;113584
2021-07-21;"Prešovský kraj";5;1076;1;1077;NA;189006;6;2021-07-21;113561
2021-07-20;"Prešovský kraj";4;1064;0;1064;NA;189006;4;2021-07-20;113555
2021-07-19;"Prešovský kraj";2;1644;4;1648;NA;189006;6;2021-07-19;113551
2021-07-18;"Prešovský kraj";1;647;0;647;NA;189006;1;2021-07-18;113545
2021-07-17;"Prešovský kraj";6;1245;1;1246;NA;189006;7;2021-07-17;113544
2021-07-16;"Prešovský kraj";4;1558;2;1560;NA;189006;6;2021-07-16;113537
2021-07-15;"Prešovský kraj";5;1310;4;1314;NA;189006;9;2021-07-15;113531
2021-07-14;"Prešovský kraj";1;1051;2;1053;NA;189006;3;2021-07-14;113522
2021-07-13;"Prešovský kraj";1;1071;2;1073;NA;189006;3;2021-07-13;113519
2021-07-12;"Prešovský kraj";1;1949;2;1951;NA;189006;3;2021-07-12;113516
2021-07-11;"Prešovský kraj";0;660;1;661;NA;189006;1;2021-07-11;113513
2021-07-10;"Prešovský kraj";4;1229;2;1231;NA;189006;6;2021-07-10;113512
2021-07-09;"Prešovský kraj";6;1957;1;1958;NA;189006;7;2021-07-09;113506
2021-07-08;"Prešovský kraj";5;1192;0;1192;NA;189006;5;2021-07-08;113499
2021-07-07;"Prešovský kraj";7;1468;3;1471;NA;189006;10;2021-07-07;113494
2021-07-06;"Prešovský kraj";5;1423;2;1425;NA;189006;7;2021-07-06;113484
2021-07-05;"Prešovský kraj";2;645;0;645;NA;189006;2;2021-07-05;113477
2021-07-04;"Prešovský kraj";0;788;0;788;NA;189006;0;2021-07-04;113475
2021-07-03;"Prešovský kraj";2;1391;0;1391;NA;189006;2;2021-07-03;113475
2021-07-02;"Prešovský kraj";4;1796;0;1796;NA;189006;4;2021-07-02;113473
2021-07-01;"Prešovský kraj";2;1590;1;1591;NA;189006;3;2021-07-01;113469
2021-06-30;"Prešovský kraj";3;8829;4;8833;NA;189006;7;2021-06-30;113466
2021-06-29;"Prešovský kraj";1;4935;3;4938;NA;189006;4;2021-06-29;113459
2021-06-28;"Prešovský kraj";5;6109;2;6111;NA;189006;7;2021-06-28;113455
2021-06-27;"Prešovský kraj";0;3852;1;3853;NA;189006;1;2021-06-27;113448
2021-06-26;"Prešovský kraj";4;5815;1;5816;NA;189006;5;2021-06-26;113447
2021-06-25;"Prešovský kraj";7;7321;4;7325;NA;189006;11;2021-06-25;113442
2021-06-24;"Prešovský kraj";10;5406;5;5411;NA;189006;15;2021-06-24;113431
2021-06-23;"Prešovský kraj";4;5124;2;5126;NA;189006;6;2021-06-23;113416
2021-06-22;"Prešovský kraj";5;5143;1;5144;NA;189006;6;2021-06-22;113410
2021-06-21;"Prešovský kraj";13;7033;6;7039;NA;189006;19;2021-06-21;113404
2021-06-20;"Prešovský kraj";0;5204;3;5207;NA;189006;3;2021-06-20;113385
2021-06-19;"Prešovský kraj";1;7349;5;7354;NA;189006;6;2021-06-19;113382
2021-06-18;"Prešovský kraj";9;8682;10;8692;NA;189006;19;2021-06-18;113376
2021-06-17;"Prešovský kraj";9;6548;5;6553;NA;189006;14;2021-06-17;113357
2021-06-16;"Prešovský kraj";6;6422;3;6425;NA;189006;9;2021-06-16;113343
2021-06-15;"Prešovský kraj";2;5709;4;5713;NA;189006;6;2021-06-15;113334
2021-06-14;"Prešovský kraj";5;8229;13;8242;NA;189006;18;2021-06-14;113328
2021-06-13;"Prešovský kraj";1;6455;7;6462;NA;189006;8;2021-06-13;113310
2021-06-12;"Prešovský kraj";3;8904;9;8913;NA;189006;12;2021-06-12;113302
2021-06-11;"Prešovský kraj";21;9877;9;9886;NA;189006;30;2021-06-11;113290
2021-06-10;"Prešovský kraj";11;6512;10;6522;NA;189006;21;2021-06-10;113260
2021-06-09;"Prešovský kraj";16;6375;3;6378;NA;189006;19;2021-06-09;113239
2021-06-08;"Prešovský kraj";31;6495;12;6507;NA;189006;43;2021-06-08;113220
2021-06-07;"Prešovský kraj";11;9111;15;9126;NA;189006;26;2021-06-07;113177
2021-06-06;"Prešovský kraj";0;8016;5;8021;NA;189006;5;2021-06-06;113151
2021-06-05;"Prešovský kraj";17;10248;15;10263;NA;189006;32;2021-06-05;113146
2021-06-04;"Prešovský kraj";26;10375;18;10393;NA;189006;44;2021-06-04;113114
2021-06-03;"Prešovský kraj";14;6820;16;6836;NA;189006;30;2021-06-03;113070
2021-06-02;"Prešovský kraj";47;7372;14;7386;NA;189006;61;2021-06-02;113040
2021-06-01;"Prešovský kraj";15;6926;14;6940;NA;189006;29;2021-06-01;112979
2021-05-31;"Prešovský kraj";27;9951;22;9973;NA;189006;49;2021-05-31;112950
2021-05-30;"Prešovský kraj";2;9717;14;9731;NA;189006;16;2021-05-30;112901
2021-05-29;"Prešovský kraj";23;12733;24;12757;NA;189006;47;2021-05-29;112885
2021-05-28;"Prešovský kraj";30;12468;19;12487;NA;189006;49;2021-05-28;112838
2021-05-27;"Prešovský kraj";16;7653;37;7690;NA;189006;53;2021-05-27;112789
2021-05-26;"Prešovský kraj";32;8140;23;8163;NA;189006;55;2021-05-26;112736
2021-05-25;"Prešovský kraj";38;8690;20;8710;NA;189006;58;2021-05-25;112681
2021-05-24;"Prešovský kraj";17;13298;37;13335;NA;189006;54;2021-05-24;112623
2021-05-23;"Prešovský kraj";3;11947;20;11967;NA;189006;23;2021-05-23;112569
2021-05-22;"Prešovský kraj";11;14422;44;14466;NA;189006;55;2021-05-22;112546
2021-05-21;"Prešovský kraj";44;13803;24;13827;NA;189006;68;2021-05-21;112491
2021-05-20;"Prešovský kraj";13;9437;29;9466;NA;189006;42;2021-05-20;112423
2021-05-19;"Prešovský kraj";60;10756;36;10792;NA;189006;96;2021-05-19;112381
2021-05-18;"Prešovský kraj";44;9062;27;9089;NA;189006;71;2021-05-18;112285
2021-05-17;"Prešovský kraj";60;12856;47;12903;NA;189006;107;2021-05-17;112214
2021-05-16;"Prešovský kraj";20;16302;66;16368;NA;189006;86;2021-05-16;112107
2021-05-15;"Prešovský kraj";20;24604;81;24685;NA;189006;101;2021-05-15;112021
2021-05-14;"Prešovský kraj";49;18671;68;18739;NA;189006;117;2021-05-14;111920
2021-05-13;"Prešovský kraj";54;11166;71;11237;NA;189006;125;2021-05-13;111803
2021-05-12;"Prešovský kraj";59;10822;39;10861;NA;189006;98;2021-05-12;111678
2021-05-11;"Prešovský kraj";61;10728;48;10776;NA;189006;109;2021-05-11;111580
2021-05-10;"Prešovský kraj";79;15726;67;15793;NA;189006;146;2021-05-10;111471
2021-05-09;"Prešovský kraj";54;21658;82;21740;NA;189006;136;2021-05-09;111325
2021-05-08;"Prešovský kraj";39;23050;52;23102;NA;189006;91;2021-05-08;111189
2021-05-07;"Prešovský kraj";81;23543;66;23609;NA;189006;147;2021-05-07;111098
2021-05-06;"Prešovský kraj";107;12924;66;12990;NA;189006;173;2021-05-06;110951
2021-05-05;"Prešovský kraj";60;12808;84;12892;NA;189006;144;2021-05-05;110778
2021-05-04;"Prešovský kraj";203;13470;67;13537;NA;189006;270;2021-05-04;110634
2021-05-03;"Prešovský kraj";68;18458;109;18567;NA;189006;177;2021-05-03;110364
2021-05-02;"Prešovský kraj";29;36676;102;36778;NA;189006;131;2021-05-02;110187
2021-05-01;"Prešovský kraj";70;57153;183;57336;NA;189006;253;2021-05-01;110056
2021-04-30;"Prešovský kraj";135;39333;118;39451;NA;189006;253;2021-04-30;109803
2021-04-29;"Prešovský kraj";110;16635;97;16732;NA;189006;207;2021-04-29;109550
2021-04-28;"Prešovský kraj";122;18671;89;18760;NA;189006;211;2021-04-28;109343
2021-04-27;"Prešovský kraj";154;19994;120;20114;NA;189006;274;2021-04-27;109132
2021-04-26;"Prešovský kraj";99;27241;123;27364;NA;189006;222;2021-04-26;108858
2021-04-25;"Prešovský kraj";9;52776;156;52932;NA;189006;165;2021-04-25;108636
2021-04-24;"Prešovský kraj";61;85698;243;85941;NA;189006;304;2021-04-24;108471
2021-04-23;"Prešovský kraj";171;40365;137;40502;NA;189006;308;2021-04-23;108167
2021-04-22;"Prešovský kraj";86;18104;125;18229;NA;189006;211;2021-04-22;107859
2021-04-21;"Prešovský kraj";144;21550;139;21689;NA;189006;283;2021-04-21;107648
2021-04-20;"Prešovský kraj";115;23346;128;23474;NA;189006;243;2021-04-20;107365
2021-04-19;"Prešovský kraj";106;29133;145;29278;NA;189006;251;2021-04-19;107122
2021-04-18;"Prešovský kraj";4;51824;129;51953;NA;189006;133;2021-04-18;106871
2021-04-17;"Prešovský kraj";119;97970;238;98208;NA;189006;357;2021-04-17;106738
2021-04-16;"Prešovský kraj";135;40989;146;41135;NA;189006;281;2021-04-16;106381
2021-04-15;"Prešovský kraj";112;20179;137;20316;NA;189006;249;2021-04-15;106100
2021-04-14;"Prešovský kraj";199;23332;130;23462;NA;189006;329;2021-04-14;105851
2021-04-13;"Prešovský kraj";180;23907;116;24023;NA;189006;296;2021-04-13;105522
2021-04-12;"Prešovský kraj";172;30152;175;30327;NA;189006;347;2021-04-12;105226
2021-04-11;"Prešovský kraj";11;49955;187;50142;NA;189006;198;2021-04-11;104879
2021-04-10;"Prešovský kraj";94;90181;297;90478;NA;189006;391;2021-04-10;104681
2021-04-09;"Prešovský kraj";255;37163;200;37363;NA;189006;455;2021-04-09;104290
2021-04-08;"Prešovský kraj";192;18893;157;19050;NA;189006;349;2021-04-08;103835
2021-04-07;"Prešovský kraj";314;27797;154;27951;NA;189006;468;2021-04-07;103486
2021-04-06;"Prešovský kraj";231;41711;268;41979;NA;189006;499;2021-04-06;103018
2021-04-05;"Prešovský kraj";54;18454;132;18586;NA;189006;186;2021-04-05;102519
2021-04-04;"Prešovský kraj";31;18569;91;18660;NA;189006;122;2021-04-04;102333
2021-04-03;"Prešovský kraj";104;90664;321;90985;NA;189006;425;2021-04-03;102211
2021-04-02;"Prešovský kraj";194;23381;134;23515;NA;189006;328;2021-04-02;101786
2021-04-01;"Prešovský kraj";256;42879;195;43074;NA;189006;451;2021-04-01;101458
2021-03-31;"Prešovský kraj";311;30176;227;30403;NA;189006;538;2021-03-31;101007
2021-03-30;"Prešovský kraj";374;20751;203;20954;NA;189006;577;2021-03-30;100469
2021-03-29;"Prešovský kraj";219;28188;229;28417;NA;189006;448;2021-03-29;99892
2021-03-28;"Prešovský kraj";26;46811;256;47067;NA;189006;282;2021-03-28;99444
2021-03-27;"Prešovský kraj";181;88673;372;89045;NA;189006;553;2021-03-27;99162
2021-03-26;"Prešovský kraj";310;47751;299;48050;NA;189006;609;2021-03-26;98609
2021-03-25;"Prešovský kraj";248;22281;213;22494;NA;189006;461;2021-03-25;98000
2021-03-24;"Prešovský kraj";381;19590;213;19803;NA;189006;594;2021-03-24;97539
2021-03-23;"Prešovský kraj";241;20351;255;20606;NA;189006;496;2021-03-23;96945
2021-03-22;"Prešovský kraj";299;28634;287;28921;NA;189006;586;2021-03-22;96449
2021-03-21;"Prešovský kraj";32;49439;266;49705;NA;189006;298;2021-03-21;95863
2021-03-20;"Prešovský kraj";180;92529;426;92955;NA;189006;606;2021-03-20;95565
2021-03-19;"Prešovský kraj";373;46582;326;46908;NA;189006;699;2021-03-19;94959
2021-03-18;"Prešovský kraj";251;21721;217;21938;NA;189006;468;2021-03-18;94260
2021-03-17;"Prešovský kraj";331;20887;231;21118;NA;189006;562;2021-03-17;93792
2021-03-16;"Prešovský kraj";461;21094;278;21372;NA;189006;739;2021-03-16;93230
2021-03-15;"Prešovský kraj";370;28813;324;29137;NA;189006;694;2021-03-15;92491
2021-03-14;"Prešovský kraj";52;50410;356;50766;NA;189006;408;2021-03-14;91797
2021-03-13;"Prešovský kraj";200;94768;531;95299;NA;189006;731;2021-03-13;91389
2021-03-12;"Prešovský kraj";425;47691;368;48059;NA;189006;793;2021-03-12;90658
2021-03-11;"Prešovský kraj";463;22059;253;22312;NA;189006;716;2021-03-11;89865
2021-03-10;"Prešovský kraj";325;20821;293;21114;NA;189006;618;2021-03-10;89149
2021-03-09;"Prešovský kraj";505;21496;288;21784;NA;189006;793;2021-03-09;88531
2021-03-08;"Prešovský kraj";314;28903;333;29236;NA;189006;647;2021-03-08;87738
2021-03-07;"Prešovský kraj";19;48328;388;48716;NA;189006;407;2021-03-07;87091
2021-03-06;"Prešovský kraj";193;97527;591;98118;NA;189006;784;2021-03-06;86684
2021-03-05;"Prešovský kraj";497;46054;397;46451;NA;189006;894;2021-03-05;85900
2021-03-04;"Prešovský kraj";372;22670;359;23029;NA;189006;731;2021-03-04;85006
2021-03-03;"Prešovský kraj";397;21623;333;21956;NA;189006;730;2021-03-03;84275
2021-03-02;"Prešovský kraj";421;22682;357;23039;NA;189006;778;2021-03-02;83545
2021-03-01;"Prešovský kraj";303;27716;406;28122;NA;189006;709;2021-03-01;82767
2021-02-28;"Prešovský kraj";75;45000;387;45387;NA;189006;462;2021-02-28;82058
2021-02-27;"Prešovský kraj";273;90231;734;90965;NA;189006;1007;2021-02-27;81596
2021-02-26;"Prešovský kraj";455;41340;438;41778;NA;189006;893;2021-02-26;80589
2021-02-25;"Prešovský kraj";270;19496;337;19833;NA;189006;607;2021-02-25;79696
2021-02-24;"Prešovský kraj";328;19026;377;19403;NA;189006;705;2021-02-24;79089
2021-02-23;"Prešovský kraj";430;21277;345;21622;NA;189006;775;2021-02-23;78384
2021-02-22;"Prešovský kraj";351;27180;356;27536;NA;189006;707;2021-02-22;77609
2021-02-21;"Prešovský kraj";66;31453;301;31754;NA;189006;367;2021-02-21;76902
2021-02-20;"Prešovský kraj";129;71413;517;71930;NA;189006;646;2021-02-20;76535
2021-02-19;"Prešovský kraj";381;38995;430;39425;NA;189006;811;2021-02-19;75889
2021-02-18;"Prešovský kraj";268;16960;322;17282;NA;189006;590;2021-02-18;75078
2021-02-17;"Prešovský kraj";293;17392;246;17638;NA;189006;539;2021-02-17;74488
2021-02-16;"Prešovský kraj";422;18862;265;19127;NA;189006;687;2021-02-16;73949
2021-02-15;"Prešovský kraj";211;31366;303;31669;NA;189006;514;2021-02-15;73262
2021-02-14;"Prešovský kraj";27;39387;321;39708;NA;189006;348;2021-02-14;72748
2021-02-13;"Prešovský kraj";157;74747;402;75149;NA;189006;559;2021-02-13;72400
2021-02-12;"Prešovský kraj";308;38758;365;39123;NA;189006;673;2021-02-12;71841
2021-02-11;"Prešovský kraj";218;16207;238;16445;NA;189006;456;2021-02-11;71168
2021-02-10;"Prešovský kraj";220;18542;282;18824;NA;189006;502;2021-02-10;70712
2021-02-09;"Prešovský kraj";323;21497;370;21867;NA;189006;693;2021-02-09;70210
2021-02-08;"Prešovský kraj";161;36924;261;37185;NA;189006;422;2021-02-08;69517
2021-02-07;"Prešovský kraj";21;34227;209;34436;NA;189006;230;2021-02-07;69095
2021-02-06;"Prešovský kraj";176;69164;360;69524;NA;189006;536;2021-02-06;68865
2021-02-05;"Prešovský kraj";177;31271;262;31533;NA;189006;439;2021-02-05;68329
2021-02-04;"Prešovský kraj";176;13080;237;13317;NA;189006;413;2021-02-04;67890
2021-02-03;"Prešovský kraj";251;8421;236;8657;NA;189006;487;2021-02-03;67477
2021-02-02;"Prešovský kraj";249;11769;264;12033;NA;189006;513;2021-02-02;66990
2021-02-01;"Prešovský kraj";220;16059;316;16375;NA;189006;536;2021-02-01;66477
2021-01-31;"Prešovský kraj";42;10587;107;10694;NA;189006;149;2021-01-31;65941
2021-01-30;"Prešovský kraj";142;23939;215;24154;NA;189006;357;2021-01-30;65792
2021-01-29;"Prešovský kraj";185;17924;326;18250;NA;189006;511;2021-01-29;65435
2021-01-28;"Prešovský kraj";311;7348;150;7498;NA;189006;461;2021-01-28;64924
2021-01-27;"Prešovský kraj";153;9730;147;9877;NA;189006;300;2021-01-27;64463
2021-01-26;"Prešovský kraj";252;16653;151;16804;NA;189006;403;2021-01-26;64163
2021-01-25;"Prešovský kraj";196;30092;253;30345;NA;189006;449;2021-01-25;63760
2021-01-24;"Prešovský kraj";12;45706;304;46010;NA;189006;316;2021-01-24;63311
2021-01-23;"Prešovský kraj";189;96883;487;97370;NA;189006;676;2021-01-23;62995
2021-01-22;"Prešovský kraj";187;35383;261;35644;NA;189006;448;2021-01-22;62319
2021-01-21;"Prešovský kraj";187;20434;212;20646;NA;189006;399;2021-01-21;61871
2021-01-20;"Prešovský kraj";253;14782;195;14977;NA;189006;448;2021-01-20;61472
2021-01-19;"Prešovský kraj";281;12329;305;12634;NA;189006;586;2021-01-19;61024
2021-01-18;"Prešovský kraj";203;10422;336;10758;NA;189006;539;2021-01-18;60438
2021-01-17;"Prešovský kraj";107;14391;1008;15399;NA;189006;1115;2021-01-17;59899
2021-01-16;"Prešovský kraj";72;1838;81;1919;NA;189006;153;2021-01-16;58784
2021-01-15;"Prešovský kraj";159;7033;257;7290;NA;189006;416;2021-01-15;58631
2021-01-14;"Prešovský kraj";268;5534;256;5790;NA;189006;524;2021-01-14;58215
2021-01-13;"Prešovský kraj";342;5649;226;5875;NA;189006;568;2021-01-13;57691
2021-01-12;"Prešovský kraj";455;8251;386;8637;NA;189006;841;2021-01-12;57123
2021-01-11;"Prešovský kraj";343;8149;471;8620;NA;189006;814;2021-01-11;56282
2021-01-10;"Prešovský kraj";63;476;23;499;NA;189006;86;2021-01-10;55468
2021-01-09;"Prešovský kraj";439;2248;125;2373;NA;189006;564;2021-01-09;55382
2021-01-08;"Prešovský kraj";430;10416;561;10977;NA;189006;991;2021-01-08;54818
2021-01-07;"Prešovský kraj";268;7432;622;8054;NA;189006;890;2021-01-07;53827
2021-01-06;"Prešovský kraj";315;1484;134;1618;NA;189006;449;2021-01-06;52937
2021-01-05;"Prešovský kraj";655;11275;976;12251;NA;189006;1631;2021-01-05;52488
2021-01-04;"Prešovský kraj";371;16845;1789;18634;NA;189006;2160;2021-01-04;50857
2021-01-03;"Prešovský kraj";89;459;41;500;NA;189006;130;2021-01-03;48697
2021-01-02;"Prešovský kraj";65;1556;160;1716;NA;189006;225;2021-01-02;48567
2021-01-01;"Prešovský kraj";174;956;71;1027;NA;189006;245;2021-01-01;48342
2020-12-31;"Prešovský kraj";640;11959;783;12742;NA;189006;1423;2020-12-31;48097
2020-12-30;"Prešovský kraj";729;8729;769;9498;NA;189006;1498;2020-12-30;46674
2020-12-29;"Prešovský kraj";435;9273;949;10222;NA;189006;1384;2020-12-29;45176
2020-12-28;"Prešovský kraj";393;9046;1079;10125;NA;189006;1472;2020-12-28;43792
2020-12-27;"Prešovský kraj";40;613;45;658;NA;189006;85;2020-12-27;42320
2020-12-26;"Prešovský kraj";64;176;12;188;NA;189006;76;2020-12-26;42235
2020-12-25;"Prešovský kraj";208;274;11;285;NA;189006;219;2020-12-25;42159
2020-12-24;"Prešovský kraj";452;1214;85;1299;NA;189006;537;2020-12-24;41940
2020-12-23;"Prešovský kraj";361;11006;618;11624;NA;189006;979;2020-12-23;41403
2020-12-22;"Prešovský kraj";439;9023;695;9718;NA;189006;1134;2020-12-22;40424
2020-12-21;"Prešovský kraj";432;9577;847;10424;NA;189006;1279;2020-12-21;39290
2020-12-20;"Prešovský kraj";184;396;20;416;NA;189006;204;2020-12-20;38011
2020-12-19;"Prešovský kraj";276;1658;151;1809;NA;189006;427;2020-12-19;37807
2020-12-18;"Prešovský kraj";396;8246;566;8812;NA;189006;962;2020-12-18;37380
2020-12-17;"Prešovský kraj";427;10505;866;11371;NA;189006;1293;2020-12-17;36418
2020-12-16;"Prešovský kraj";466;5613;473;6086;NA;189006;939;2020-12-16;35125
2020-12-15;"Prešovský kraj";411;5406;574;5980;NA;189006;985;2020-12-15;34186
2020-12-14;"Prešovský kraj";334;5538;477;6015;NA;189006;811;2020-12-14;33201
2020-12-13;"Prešovský kraj";89;29;8;37;NA;189006;97;2020-12-13;32390
2020-12-12;"Prešovský kraj";319;2474;166;2640;NA;189006;485;2020-12-12;32293
2020-12-11;"Prešovský kraj";560;5602;402;6004;NA;189006;962;2020-12-11;31808
2020-12-10;"Prešovský kraj";337;5019;423;5442;NA;189006;760;2020-12-10;30846
2020-12-09;"Prešovský kraj";358;4357;314;4671;NA;189006;672;2020-12-09;30086
2020-12-08;"Prešovský kraj";350;6629;651;7280;NA;189006;1001;2020-12-08;29414
2020-12-07;"Prešovský kraj";309;4345;327;4672;NA;189006;636;2020-12-07;28413
2020-12-06;"Prešovský kraj";59;655;26;681;NA;189006;85;2020-12-06;27777
2020-12-05;"Prešovský kraj";218;984;87;1071;NA;189006;305;2020-12-05;27692
2020-12-04;"Prešovský kraj";352;5070;293;5363;NA;189006;645;2020-12-04;27387
2020-12-03;"Prešovský kraj";284;2456;179;2635;NA;189006;463;2020-12-03;26742
2020-12-02;"Prešovský kraj";232;2830;225;3055;NA;189006;457;2020-12-02;26279
2020-12-01;"Prešovský kraj";281;1884;196;2080;NA;189006;477;2020-12-01;25822
2020-11-30;"Prešovský kraj";196;5333;97;5430;NA;189006;293;2020-11-30;25345
2020-11-29;"Prešovský kraj";27;379;42;421;NA;189006;69;2020-11-29;25052
2020-11-28;"Prešovský kraj";199;772;77;849;NA;189006;276;2020-11-28;24983
2020-11-27;"Prešovský kraj";232;2350;130;2480;NA;189006;362;2020-11-27;24707
2020-11-26;"Prešovský kraj";263;3014;329;3343;NA;189006;592;2020-11-26;24345
2020-11-25;"Prešovský kraj";302;2174;103;2277;NA;189006;405;2020-11-25;23753
2020-11-24;"Prešovský kraj";365;1777;156;1933;NA;189006;521;2020-11-24;23348
2020-11-23;"Prešovský kraj";164;1099;60;1159;NA;189006;224;2020-11-23;22827
2020-11-22;"Prešovský kraj";46;44;1;45;NA;189006;47;2020-11-22;22603
2020-11-21;"Prešovský kraj";205;754;62;816;NA;189006;267;2020-11-21;22556
2020-11-20;"Prešovský kraj";363;2258;102;2360;NA;189006;465;2020-11-20;22289
2020-11-19;"Prešovský kraj";359;2096;238;2334;NA;189006;597;2020-11-19;21824
2020-11-18;"Prešovský kraj";270;488;43;531;NA;189006;313;2020-11-18;21227
2020-11-17;"Prešovský kraj";347;205;23;228;NA;189006;370;2020-11-17;20914
2020-11-16;"Prešovský kraj";226;540;58;598;NA;189006;284;2020-11-16;20544
2020-11-15;"Prešovský kraj";186;39;4;43;NA;189006;190;2020-11-15;20260
2020-11-14;"Prešovský kraj";261;54;4;58;NA;189006;265;2020-11-14;20070
2020-11-13;"Prešovský kraj";395;166;8;174;NA;189006;403;2020-11-13;19805
2020-11-12;"Prešovský kraj";397;229;50;279;NA;189006;447;2020-11-12;19402
2020-11-11;"Prešovský kraj";516;161;15;176;NA;189006;531;2020-11-11;18955
2020-11-10;"Prešovský kraj";437;197;9;206;NA;189006;446;2020-11-10;18424
2020-11-09;"Prešovský kraj";190;4110;945;5055;NA;189006;1135;2020-11-09;17978
2020-11-08;"Prešovský kraj";97;2817;32;2849;NA;189006;129;2020-11-08;16843
2020-11-07;"Prešovský kraj";416;8578;81;8659;NA;189006;497;2020-11-07;16714
2020-11-06;"Prešovský kraj";520;4791;76;4867;NA;189006;596;2020-11-06;16217
2020-11-05;"Prešovský kraj";397;180;5;185;NA;189006;402;2020-11-05;15621
2020-11-04;"Prešovský kraj";350;807;8;815;NA;189006;358;2020-11-04;15219
2020-11-03;"Prešovský kraj";565;98;12;110;NA;189006;577;2020-11-03;14861
2020-11-02;"Prešovský kraj";203;4158;1004;5162;NA;189006;1207;2020-11-02;14284
2020-11-01;"Prešovský kraj";386;2906;53;2959;NA;189006;439;2020-11-01;13077
2020-10-31;"Prešovský kraj";315;10497;170;10667;NA;189006;485;2020-10-31;12638
2020-10-30;"Prešovský kraj";552;2949;65;3014;NA;189006;617;2020-10-30;12153
2020-10-29;"Prešovský kraj";594;301;38;339;NA;189006;632;2020-10-29;11536
2020-10-28;"Prešovský kraj";617;291;46;337;NA;189006;663;2020-10-28;10904
2020-10-27;"Prešovský kraj";656;268;34;302;NA;189006;690;2020-10-27;10241
2020-10-26;"Prešovský kraj";137;363;57;420;NA;189006;194;2020-10-26;9551
2020-10-25;"Prešovský kraj";237;346;11;357;NA;189006;248;2020-10-25;9357
2020-10-24;"Prešovský kraj";719;200;12;212;NA;189006;731;2020-10-24;9109
2020-10-23;"Prešovský kraj";750;218;8;226;NA;189006;758;2020-10-23;8378
2020-10-22;"Prešovský kraj";646;396;30;426;NA;189006;676;2020-10-22;7620
2020-10-21;"Prešovský kraj";383;58;8;66;NA;189006;391;2020-10-21;6944
2020-10-20;"Prešovský kraj";493;65;7;72;NA;189006;500;2020-10-20;6553
2020-10-19;"Prešovský kraj";140;235;15;250;NA;189006;155;2020-10-19;6053
2020-10-18;"Prešovský kraj";209;0;0;0;NA;189006;209;2020-10-18;5898
2020-10-17;"Prešovský kraj";342;0;0;0;NA;189006;342;2020-10-17;5689
2020-10-16;"Prešovský kraj";388;57;3;60;NA;189006;391;2020-10-16;5347
2020-10-15;"Prešovský kraj";435;85;18;103;NA;189006;453;2020-10-15;4956
2020-10-14;"Prešovský kraj";451;54;10;64;NA;189006;461;2020-10-14;4503
2020-10-13;"Prešovský kraj";264;50;6;56;NA;189006;270;2020-10-13;4042
2020-10-12;"Prešovský kraj";214;334;35;369;NA;189006;249;2020-10-12;3772
2020-10-11;"Prešovský kraj";127;0;0;0;NA;189006;127;2020-10-11;3523
2020-10-10;"Prešovský kraj";248;0;0;0;NA;189006;248;2020-10-10;3396
2020-10-09;"Prešovský kraj";406;0;0;0;NA;189006;406;2020-10-09;3148
2020-10-08;"Prešovský kraj";245;0;0;0;NA;189006;245;2020-10-08;2742
2020-10-07;"Prešovský kraj";244;0;0;0;NA;189006;244;2020-10-07;2497
2020-10-06;"Prešovský kraj";166;0;0;0;NA;189006;166;2020-10-06;2253
2020-10-05;"Prešovský kraj";84;0;0;0;NA;189006;84;2020-10-05;2087
2020-10-04;"Prešovský kraj";118;0;0;0;NA;189006;118;2020-10-04;2003
2020-10-03;"Prešovský kraj";204;0;0;0;NA;189006;204;2020-10-03;1885
2020-10-02;"Prešovský kraj";149;0;0;0;NA;189006;149;2020-10-02;1681
2020-10-01;"Prešovský kraj";136;0;0;0;NA;189006;136;2020-10-01;1532
2020-09-30;"Prešovský kraj";121;0;0;0;NA;189006;121;2020-09-30;1396
2020-09-29;"Prešovský kraj";156;0;0;0;NA;189006;156;2020-09-29;1275
2020-09-28;"Prešovský kraj";51;0;0;0;NA;189006;51;2020-09-28;1119
2020-09-27;"Prešovský kraj";10;0;0;0;NA;189006;10;2020-09-27;1068
2020-09-26;"Prešovský kraj";72;0;0;0;NA;189006;72;2020-09-26;1058
2020-09-25;"Prešovský kraj";91;0;0;0;NA;189006;91;2020-09-25;986
2020-09-24;"Prešovský kraj";52;0;0;0;NA;189006;52;2020-09-24;895
2020-09-23;"Prešovský kraj";55;0;0;0;NA;189006;55;2020-09-23;843
2020-09-22;"Prešovský kraj";29;0;0;0;NA;189006;29;2020-09-22;788
2020-09-21;"Prešovský kraj";14;0;0;0;NA;189006;14;2020-09-21;759
2020-09-20;"Prešovský kraj";5;0;0;0;NA;189006;5;2020-09-20;745
2020-09-19;"Prešovský kraj";12;0;0;0;NA;189006;12;2020-09-19;740
2020-09-18;"Prešovský kraj";29;0;0;0;NA;189006;29;2020-09-18;728
2020-09-17;"Prešovský kraj";25;0;0;0;NA;189006;25;2020-09-17;699
2020-09-16;"Prešovský kraj";8;0;0;0;NA;189006;8;2020-09-16;674
2020-09-15;"Prešovský kraj";10;0;0;0;NA;189006;10;2020-09-15;666
2020-09-14;"Prešovský kraj";47;0;0;0;NA;189006;47;2020-09-14;656
2020-09-13;"Prešovský kraj";3;0;0;0;NA;189006;3;2020-09-13;609
2020-09-12;"Prešovský kraj";4;0;0;0;NA;189006;4;2020-09-12;606
2020-09-11;"Prešovský kraj";15;0;0;0;NA;189006;15;2020-09-11;602
2020-09-10;"Prešovský kraj";10;0;0;0;NA;189006;10;2020-09-10;587
2020-09-09;"Prešovský kraj";21;0;0;0;NA;189006;21;2020-09-09;577
2020-09-08;"Prešovský kraj";23;0;0;0;NA;189006;23;2020-09-08;556
2020-09-07;"Prešovský kraj";5;0;0;0;NA;189006;5;2020-09-07;533
2020-09-06;"Prešovský kraj";3;0;0;0;NA;189006;3;2020-09-06;528
2020-09-05;"Prešovský kraj";7;0;0;0;NA;189006;7;2020-09-05;525
2020-09-04;"Prešovský kraj";24;0;0;0;NA;189006;24;2020-09-04;518
2020-09-03;"Prešovský kraj";8;0;0;0;NA;189006;8;2020-09-03;494
2020-09-02;"Prešovský kraj";9;0;0;0;NA;189006;9;2020-09-02;486
2020-09-01;"Prešovský kraj";6;0;0;0;NA;189006;6;2020-09-01;477
2020-08-31;"Prešovský kraj";3;0;0;0;NA;189006;3;2020-08-31;471
2020-08-30;"Prešovský kraj";6;0;0;0;NA;189006;6;2020-08-30;468
2020-08-29;"Prešovský kraj";4;0;0;0;NA;189006;4;2020-08-29;462
2020-08-28;"Prešovský kraj";6;0;0;0;NA;189006;6;2020-08-28;458
2020-08-27;"Prešovský kraj";7;0;0;0;NA;189006;7;2020-08-27;452
2020-08-26;"Prešovský kraj";22;0;0;0;NA;189006;22;2020-08-26;445
2020-08-25;"Prešovský kraj";1;0;0;0;NA;189006;1;2020-08-25;423
2020-08-24;"Prešovský kraj";5;0;0;0;NA;189006;5;2020-08-24;422
2020-08-23;"Prešovský kraj";3;0;0;0;NA;189006;3;2020-08-23;417
2020-08-22;"Prešovský kraj";3;0;0;0;NA;189006;3;2020-08-22;414
2020-08-21;"Prešovský kraj";11;0;0;0;NA;189006;11;2020-08-21;411
2020-08-20;"Prešovský kraj";8;0;0;0;NA;189006;8;2020-08-20;400
2020-08-19;"Prešovský kraj";8;0;0;0;NA;189006;8;2020-08-19;392
2020-08-18;"Prešovský kraj";6;0;0;0;NA;189006;6;2020-08-18;384
2020-08-17;"Prešovský kraj";1;0;0;0;NA;189006;1;2020-08-17;378
2020-08-16;"Prešovský kraj";0;0;0;0;NA;189006;0;2020-08-16;377
2020-08-15;"Prešovský kraj";8;0;0;0;NA;189006;8;2020-08-15;377
2020-08-14;"Prešovský kraj";6;0;0;0;NA;189006;6;2020-08-14;369
2020-08-13;"Prešovský kraj";8;0;0;0;NA;189006;8;2020-08-13;363
2020-08-12;"Prešovský kraj";19;0;0;0;NA;189006;19;2020-08-12;355
2020-08-11;"Prešovský kraj";3;0;0;0;NA;189006;3;2020-08-11;336
2020-08-10;"Prešovský kraj";0;0;0;0;NA;189006;0;2020-08-10;333
2020-08-09;"Prešovský kraj";0;0;0;0;NA;189006;0;2020-08-09;333
2020-08-08;"Prešovský kraj";2;0;0;0;NA;189006;2;2020-08-08;333
2020-08-07;"Prešovský kraj";6;0;0;0;NA;189006;6;2020-08-07;331
2020-08-06;"Prešovský kraj";2;0;0;0;NA;189006;2;2020-08-06;325
2020-08-05;"Prešovský kraj";8;0;0;0;NA;189006;8;2020-08-05;323
2020-08-04;"Prešovský kraj";5;0;0;0;NA;189006;5;2020-08-04;315
2020-08-03;"Prešovský kraj";4;0;0;0;NA;189006;4;2020-08-03;310
2020-08-02;"Prešovský kraj";6;0;0;0;NA;189006;6;2020-08-02;306
2020-08-01;"Prešovský kraj";0;0;0;0;NA;189006;0;2020-08-01;300
2020-07-31;"Prešovský kraj";2;0;0;0;NA;189006;2;2020-07-31;300
2020-07-30;"Prešovský kraj";6;0;0;0;NA;189006;6;2020-07-30;298
2020-07-29;"Prešovský kraj";5;0;0;0;NA;189006;5;2020-07-29;292
2020-07-28;"Prešovský kraj";0;0;0;0;NA;189006;0;2020-07-28;287
2020-07-27;"Prešovský kraj";1;0;0;0;NA;189006;1;2020-07-27;287
2020-07-26;"Prešovský kraj";1;0;0;0;NA;189006;1;2020-07-26;286
2020-07-25;"Prešovský kraj";21;0;0;0;NA;189006;21;2020-07-25;285
2020-07-24;"Prešovský kraj";1;0;0;0;NA;189006;1;2020-07-24;264
2020-07-23;"Prešovský kraj";5;0;0;0;NA;189006;5;2020-07-23;263
2020-07-22;"Prešovský kraj";1;0;0;0;NA;189006;1;2020-07-22;258
2020-07-21;"Prešovský kraj";2;0;0;0;NA;189006;2;2020-07-21;257
2020-07-20;"Prešovský kraj";1;0;0;0;NA;189006;1;2020-07-20;255
2020-07-19;"Prešovský kraj";0;0;0;0;NA;189006;0;2020-07-19;254
2020-07-18;"Prešovský kraj";0;0;0;0;NA;189006;0;2020-07-18;254
2020-07-17;"Prešovský kraj";3;0;0;0;NA;189006;3;2020-07-17;254
2020-07-16;"Prešovský kraj";1;0;0;0;NA;189006;1;2020-07-16;251
2020-07-15;"Prešovský kraj";5;0;0;0;NA;189006;5;2020-07-15;250
2020-07-14;"Prešovský kraj";5;0;0;0;NA;189006;5;2020-07-14;245
2020-07-13;"Prešovský kraj";1;0;0;0;NA;189006;1;2020-07-13;240
2020-07-12;"Prešovský kraj";1;0;0;0;NA;189006;1;2020-07-12;239
2020-07-11;"Prešovský kraj";6;0;0;0;NA;189006;6;2020-07-11;238
2020-07-10;"Prešovský kraj";5;0;0;0;NA;189006;5;2020-07-10;232
2020-07-09;"Prešovský kraj";2;0;0;0;NA;189006;2;2020-07-09;227
2020-07-08;"Prešovský kraj";14;0;0;0;NA;189006;14;2020-07-08;225
2020-07-07;"Prešovský kraj";2;0;0;0;NA;189006;2;2020-07-07;211
2020-07-06;"Prešovský kraj";0;0;0;0;NA;189006;0;2020-07-06;209
2020-07-05;"Prešovský kraj";0;0;0;0;NA;189006;0;2020-07-05;209
2020-07-04;"Prešovský kraj";1;0;0;0;NA;189006;1;2020-07-04;209
2020-07-03;"Prešovský kraj";3;0;0;0;NA;189006;3;2020-07-03;208
2020-07-02;"Prešovský kraj";0;0;0;0;NA;189006;0;2020-07-02;205
2020-07-01;"Prešovský kraj";0;0;0;0;NA;189006;0;2020-07-01;205
2020-06-30;"Prešovský kraj";7;0;0;0;NA;189006;7;2020-06-30;205
2020-06-29;"Prešovský kraj";0;0;0;0;NA;189006;0;2020-06-29;198
2020-06-28;"Prešovský kraj";0;0;0;0;NA;189006;0;2020-06-28;198
2020-06-27;"Prešovský kraj";3;0;0;0;NA;189006;3;2020-06-27;198
2020-06-26;"Prešovský kraj";3;0;0;0;NA;189006;3;2020-06-26;195
2020-06-25;"Prešovský kraj";0;0;0;0;NA;189006;0;2020-06-25;192
2020-06-24;"Prešovský kraj";4;0;0;0;NA;189006;4;2020-06-24;192
2020-06-23;"Prešovský kraj";0;0;0;0;NA;189006;0;2020-06-23;188
2020-06-22;"Prešovský kraj";0;0;0;0;NA;189006;0;2020-06-22;188
2020-06-21;"Prešovský kraj";0;0;0;0;NA;189006;0;2020-06-21;188
2020-06-20;"Prešovský kraj";0;0;0;0;NA;189006;0;2020-06-20;188
2020-06-19;"Prešovský kraj";1;0;0;0;NA;189006;1;2020-06-19;188
2020-06-18;"Prešovský kraj";0;0;0;0;NA;189006;0;2020-06-18;187
2020-06-17;"Prešovský kraj";0;0;0;0;NA;189006;0;2020-06-17;187
2020-06-16;"Prešovský kraj";6;0;0;0;NA;189006;6;2020-06-16;187
2020-06-14;"Prešovský kraj";0;0;0;0;NA;189006;0;2020-06-14;181
2020-06-13;"Prešovský kraj";0;0;0;0;NA;189006;0;2020-06-13;181
2020-06-12;"Prešovský kraj";1;0;0;0;NA;189006;1;2020-06-12;181
2020-06-11;"Prešovský kraj";0;0;0;0;NA;189006;0;2020-06-11;180
2020-06-10;"Prešovský kraj";0;0;0;0;NA;189006;0;2020-06-10;180
2020-06-09;"Prešovský kraj";0;0;0;0;NA;189006;0;2020-06-09;180
2020-06-08;"Prešovský kraj";0;0;0;0;NA;189006;0;2020-06-08;180
2020-06-07;"Prešovský kraj";0;0;0;0;NA;189006;0;2020-06-07;180
2020-06-05;"Prešovský kraj";0;0;0;0;NA;189006;0;2020-06-05;180
2020-06-03;"Prešovský kraj";0;0;0;0;NA;189006;0;2020-06-03;180
2020-06-02;"Prešovský kraj";1;0;0;0;NA;189006;1;2020-06-02;180
2020-05-31;"Prešovský kraj";1;0;0;0;NA;189006;1;2020-05-31;179
2020-05-29;"Prešovský kraj";0;0;0;0;NA;189006;0;2020-05-29;178
2020-05-27;"Prešovský kraj";0;0;0;0;NA;189006;0;2020-05-27;178
2020-05-26;"Prešovský kraj";0;0;0;0;NA;189006;0;2020-05-26;178
2020-05-25;"Prešovský kraj";0;0;0;0;NA;189006;0;2020-05-25;178
2020-05-24;"Prešovský kraj";0;0;0;0;NA;189006;0;2020-05-24;178
2020-05-23;"Prešovský kraj";0;0;0;0;NA;189006;0;2020-05-23;178
2020-05-22;"Prešovský kraj";0;0;0;0;NA;189006;0;2020-05-22;178
2020-05-21;"Prešovský kraj";1;0;0;0;NA;189006;1;2020-05-21;178
2020-05-20;"Prešovský kraj";0;0;0;0;NA;189006;0;2020-05-20;177
2020-05-19;"Prešovský kraj";0;0;0;0;NA;189006;0;2020-05-19;177
2020-05-17;"Prešovský kraj";0;0;0;0;NA;189006;0;2020-05-17;177
2020-05-16;"Prešovský kraj";0;0;0;0;NA;189006;0;2020-05-16;177
2020-05-15;"Prešovský kraj";0;0;0;0;NA;189006;0;2020-05-15;177
2020-05-14;"Prešovský kraj";0;0;0;0;NA;189006;0;2020-05-14;177
2020-05-13;"Prešovský kraj";1;0;0;0;NA;189006;1;2020-05-13;177
2020-05-12;"Prešovský kraj";0;0;0;0;NA;189006;0;2020-05-12;176
2020-05-11;"Prešovský kraj";1;0;0;0;NA;189006;1;2020-05-11;176
2020-05-09;"Prešovský kraj";0;0;0;0;NA;189006;0;2020-05-09;175
2020-05-07;"Prešovský kraj";0;0;0;0;NA;189006;0;2020-05-07;175
2020-05-06;"Prešovský kraj";0;0;0;0;NA;189006;0;2020-05-06;175
2020-05-05;"Prešovský kraj";1;0;0;0;NA;189006;1;2020-05-05;175
2020-05-04;"Prešovský kraj";0;0;0;0;NA;189006;0;2020-05-04;174
2020-05-03;"Prešovský kraj";0;0;0;0;NA;189006;0;2020-05-03;174
2020-05-02;"Prešovský kraj";0;0;0;0;NA;189006;0;2020-05-02;174
2020-05-01;"Prešovský kraj";2;0;0;0;NA;189006;2;2020-05-01;174
2020-04-30;"Prešovský kraj";0;0;0;0;NA;189006;0;2020-04-30;172
2020-04-29;"Prešovský kraj";1;0;0;0;NA;189006;1;2020-04-29;172
2020-04-28;"Prešovský kraj";1;0;0;0;NA;189006;1;2020-04-28;171
2020-04-27;"Prešovský kraj";2;0;0;0;NA;189006;2;2020-04-27;170
2020-04-26;"Prešovský kraj";0;0;0;0;NA;189006;0;2020-04-26;168
2020-04-25;"Prešovský kraj";0;0;0;0;NA;189006;0;2020-04-25;168
2020-04-24;"Prešovský kraj";0;0;0;0;NA;189006;0;2020-04-24;168
2020-04-23;"Prešovský kraj";2;0;0;0;NA;189006;2;2020-04-23;168
2020-04-22;"Prešovský kraj";11;0;0;0;NA;189006;11;2020-04-22;166
2020-04-21;"Prešovský kraj";12;0;0;0;NA;189006;12;2020-04-21;155
2020-04-20;"Prešovský kraj";2;0;0;0;NA;189006;2;2020-04-20;143
2020-04-19;"Prešovský kraj";4;0;0;0;NA;189006;4;2020-04-19;141
2020-04-18;"Prešovský kraj";1;0;0;0;NA;189006;1;2020-04-18;137
2020-04-17;"Prešovský kraj";4;0;0;0;NA;189006;4;2020-04-17;136
2020-04-16;"Prešovský kraj";9;0;0;0;NA;189006;9;2020-04-16;132
2020-04-15;"Prešovský kraj";21;0;0;0;NA;189006;21;2020-04-15;123
2020-04-14;"Prešovský kraj";1;0;0;0;NA;189006;1;2020-04-14;102
2020-04-13;"Prešovský kraj";2;0;0;0;NA;189006;2;2020-04-13;101
2020-04-12;"Prešovský kraj";6;0;0;0;NA;189006;6;2020-04-12;99
2020-04-11;"Prešovský kraj";4;0;0;0;NA;189006;4;2020-04-11;93
2020-04-10;"Prešovský kraj";0;0;0;0;NA;189006;0;2020-04-10;89
2020-04-09;"Prešovský kraj";1;0;0;0;NA;189006;1;2020-04-09;89
2020-04-08;"Prešovský kraj";0;0;0;0;NA;189006;0;2020-04-08;88
2020-04-07;"Prešovský kraj";7;0;0;0;NA;189006;7;2020-04-07;88
2020-04-06;"Prešovský kraj";10;0;0;0;NA;189006;10;2020-04-06;81
2020-04-05;"Prešovský kraj";13;0;0;0;NA;189006;13;2020-04-05;71
2020-04-04;"Prešovský kraj";1;0;0;0;NA;189006;1;2020-04-04;58
2020-04-03;"Prešovský kraj";4;0;0;0;NA;189006;4;2020-04-03;57
2020-04-02;"Prešovský kraj";6;0;0;0;NA;189006;6;2020-04-02;53
2020-04-01;"Prešovský kraj";6;0;0;0;NA;189006;6;2020-04-01;47
2020-03-31;"Prešovský kraj";6;0;0;0;NA;189006;6;2020-03-31;41
2020-03-30;"Prešovský kraj";2;0;0;0;NA;189006;2;2020-03-30;35
2020-03-29;"Prešovský kraj";2;0;0;0;NA;189006;2;2020-03-29;33
2020-03-28;"Prešovský kraj";2;0;0;0;NA;189006;2;2020-03-28;31
2020-03-27;"Prešovský kraj";1;0;0;0;NA;189006;1;2020-03-27;29
2020-03-26;"Prešovský kraj";8;0;0;0;NA;189006;8;2020-03-26;28
2020-03-25;"Prešovský kraj";1;0;0;0;NA;189006;1;2020-03-25;20
2020-03-24;"Prešovský kraj";4;0;0;0;NA;189006;4;2020-03-24;19
2020-03-23;"Prešovský kraj";0;0;0;0;NA;189006;0;2020-03-23;15
2020-03-22;"Prešovský kraj";1;0;0;0;NA;189006;1;2020-03-22;15
2020-03-21;"Prešovský kraj";2;0;0;0;NA;189006;2;2020-03-21;14
2020-03-20;"Prešovský kraj";3;0;0;0;NA;189006;3;2020-03-20;12
2020-03-19;"Prešovský kraj";2;0;0;0;NA;189006;2;2020-03-19;9
2020-03-18;"Prešovský kraj";1;0;0;0;NA;189006;1;2020-03-18;7
2020-03-17;"Prešovský kraj";1;0;0;0;NA;189006;1;2020-03-17;6
2020-03-16;"Prešovský kraj";4;0;0;0;NA;189006;4;2020-03-16;5
2020-03-15;"Prešovský kraj";0;0;0;0;NA;189006;0;2020-03-15;1
2020-03-14;"Prešovský kraj";1;0;0;0;NA;189006;1;2020-03-14;1
2020-03-13;"Prešovský kraj";0;0;0;0;NA;189006;0;2020-03-13;0
2020-03-12;"Prešovský kraj";0;0;0;0;NA;189006;0;2020-03-12;0
2020-03-11;"Prešovský kraj";0;0;0;0;NA;189006;0;2020-03-11;0
2020-03-09;"Prešovský kraj";0;0;0;0;NA;189006;0;2020-03-09;0
2020-03-08;"Prešovský kraj";0;0;0;0;NA;189006;0;2020-03-08;0
2020-03-07;"Prešovský kraj";0;0;0;0;NA;189006;0;2020-03-07;0
2020-03-06;"Prešovský kraj";0;0;0;0;NA;189006;0;2020-03-06;0
2021-12-02;"Trenčiansky kraj";2007;0;0;0;87741;148091;2007;2021-12-02;148091
2021-12-01;"Trenčiansky kraj";1000;2634;189;2823;NA;148091;1189;2021-12-01;146084
2021-11-30;"Trenčiansky kraj";1086;4261;292;4553;NA;148091;1378;2021-11-30;144895
2021-11-29;"Trenčiansky kraj";1165;9811;504;10315;NA;148091;1669;2021-11-29;143517
2021-11-28;"Trenčiansky kraj";664;5235;264;5499;NA;148091;928;2021-11-28;141848
2021-11-27;"Trenčiansky kraj";1080;2686;298;2984;NA;148091;1378;2021-11-27;140920
2021-11-26;"Trenčiansky kraj";1238;4427;335;4762;NA;148091;1573;2021-11-26;139542
2021-11-25;"Trenčiansky kraj";1018;3515;330;3845;NA;148091;1348;2021-11-25;137969
2021-11-24;"Trenčiansky kraj";1362;5554;465;6019;NA;148091;1827;2021-11-24;136621
2021-11-23;"Trenčiansky kraj";1140;3717;347;4064;NA;148091;1487;2021-11-23;134794
2021-11-22;"Trenčiansky kraj";920;6459;566;7025;NA;148091;1486;2021-11-22;133307
2021-11-21;"Trenčiansky kraj";413;3234;377;3611;NA;148091;790;2021-11-21;131821
2021-11-20;"Trenčiansky kraj";914;2378;341;2719;NA;148091;1255;2021-11-20;131031
2021-11-19;"Trenčiansky kraj";1261;3783;445;4228;NA;148091;1706;2021-11-19;129776
2021-11-18;"Trenčiansky kraj";810;5021;524;5545;NA;148091;1334;2021-11-18;128070
2021-11-17;"Trenčiansky kraj";796;1852;237;2089;NA;148091;1033;2021-11-17;126736
2021-11-16;"Trenčiansky kraj";859;4060;401;4461;NA;148091;1260;2021-11-16;125703
2021-11-15;"Trenčiansky kraj";720;5114;550;5664;NA;148091;1270;2021-11-15;124443
2021-11-14;"Trenčiansky kraj";447;2462;343;2805;NA;148091;790;2021-11-14;123173
2021-11-13;"Trenčiansky kraj";478;1879;254;2133;NA;148091;732;2021-11-13;122383
2021-11-12;"Trenčiansky kraj";784;3855;338;4193;NA;148091;1122;2021-11-12;121651
2021-11-11;"Trenčiansky kraj";805;3561;345;3906;NA;148091;1150;2021-11-11;120529
2021-11-10;"Trenčiansky kraj";647;3358;279;3637;NA;148091;926;2021-11-10;119379
2021-11-09;"Trenčiansky kraj";752;2886;304;3190;NA;148091;1056;2021-11-09;118453
2021-11-08;"Trenčiansky kraj";489;4643;348;4991;NA;148091;837;2021-11-08;117397
2021-11-07;"Trenčiansky kraj";405;2043;220;2263;NA;148091;625;2021-11-07;116560
2021-11-06;"Trenčiansky kraj";542;1755;176;1931;NA;148091;718;2021-11-06;115935
2021-11-05;"Trenčiansky kraj";677;3083;238;3321;NA;148091;915;2021-11-05;115217
2021-11-04;"Trenčiansky kraj";563;2713;229;2942;NA;148091;792;2021-11-04;114302
2021-11-03;"Trenčiansky kraj";619;2955;222;3177;NA;148091;841;2021-11-03;113510
2021-11-02;"Trenčiansky kraj";663;3808;309;4117;NA;148091;972;2021-11-02;112669
2021-11-01;"Trenčiansky kraj";219;1029;101;1130;NA;148091;320;2021-11-01;111697
2021-10-31;"Trenčiansky kraj";151;1462;152;1614;NA;148091;303;2021-10-31;111377
2021-10-30;"Trenčiansky kraj";345;1770;130;1900;NA;148091;475;2021-10-30;111074
2021-10-29;"Trenčiansky kraj";415;2860;129;2989;NA;148091;544;2021-10-29;110599
2021-10-28;"Trenčiansky kraj";429;2653;157;2810;NA;148091;586;2021-10-28;110055
2021-10-27;"Trenčiansky kraj";463;2612;93;2705;NA;148091;556;2021-10-27;109469
2021-10-26;"Trenčiansky kraj";419;2635;133;2768;NA;148091;552;2021-10-26;108913
2021-10-25;"Trenčiansky kraj";192;3370;130;3500;NA;148091;322;2021-10-25;108361
2021-10-24;"Trenčiansky kraj";121;1643;79;1722;NA;148091;200;2021-10-24;108039
2021-10-23;"Trenčiansky kraj";326;1737;64;1801;NA;148091;390;2021-10-23;107839
2021-10-22;"Trenčiansky kraj";358;2694;78;2772;NA;148091;436;2021-10-22;107449
2021-10-21;"Trenčiansky kraj";247;2343;74;2417;NA;148091;321;2021-10-21;107013
2021-10-20;"Trenčiansky kraj";302;2101;70;2171;NA;148091;372;2021-10-20;106692
2021-10-19;"Trenčiansky kraj";227;2847;59;2906;NA;148091;286;2021-10-19;106320
2021-10-18;"Trenčiansky kraj";143;2453;71;2524;NA;148091;214;2021-10-18;106034
2021-10-17;"Trenčiansky kraj";46;1457;31;1488;NA;148091;77;2021-10-17;105820
2021-10-16;"Trenčiansky kraj";76;1671;35;1706;NA;148091;111;2021-10-16;105743
2021-10-15;"Trenčiansky kraj";126;2925;50;2975;NA;148091;176;2021-10-15;105632
2021-10-14;"Trenčiansky kraj";103;1717;27;1744;NA;148091;130;2021-10-14;105456
2021-10-13;"Trenčiansky kraj";171;2656;28;2684;NA;148091;199;2021-10-13;105326
2021-10-12;"Trenčiansky kraj";114;2350;32;2382;NA;148091;146;2021-10-12;105127
2021-10-11;"Trenčiansky kraj";109;2541;48;2589;NA;148091;157;2021-10-11;104981
2021-10-10;"Trenčiansky kraj";17;1487;23;1510;NA;148091;40;2021-10-10;104824
2021-10-09;"Trenčiansky kraj";157;1809;16;1825;NA;148091;173;2021-10-09;104784
2021-10-08;"Trenčiansky kraj";82;3087;37;3124;NA;148091;119;2021-10-08;104611
2021-10-07;"Trenčiansky kraj";107;2039;30;2069;NA;148091;137;2021-10-07;104492
2021-10-06;"Trenčiansky kraj";193;2289;36;2325;NA;148091;229;2021-10-06;104355
2021-10-05;"Trenčiansky kraj";119;2229;40;2269;NA;148091;159;2021-10-05;104126
2021-10-04;"Trenčiansky kraj";105;2769;52;2821;NA;148091;157;2021-10-04;103967
2021-10-03;"Trenčiansky kraj";30;1558;27;1585;NA;148091;57;2021-10-03;103810
2021-10-02;"Trenčiansky kraj";107;1794;35;1829;NA;148091;142;2021-10-02;103753
2021-10-01;"Trenčiansky kraj";119;2690;37;2727;NA;148091;156;2021-10-01;103611
2021-09-30;"Trenčiansky kraj";74;2327;50;2377;NA;148091;124;2021-09-30;103455
2021-09-29;"Trenčiansky kraj";170;2150;30;2180;NA;148091;200;2021-09-29;103331
2021-09-28;"Trenčiansky kraj";95;2267;31;2298;NA;148091;126;2021-09-28;103131
2021-09-27;"Trenčiansky kraj";56;2813;57;2870;NA;148091;113;2021-09-27;103005
2021-09-26;"Trenčiansky kraj";20;1675;33;1708;NA;148091;53;2021-09-26;102892
2021-09-25;"Trenčiansky kraj";76;1674;21;1695;NA;148091;97;2021-09-25;102839
2021-09-24;"Trenčiansky kraj";104;3220;35;3255;NA;148091;139;2021-09-24;102742
2021-09-23;"Trenčiansky kraj";91;2251;27;2278;NA;148091;118;2021-09-23;102603
2021-09-22;"Trenčiansky kraj";90;2146;24;2170;NA;148091;114;2021-09-22;102485
2021-09-21;"Trenčiansky kraj";79;2307;29;2336;NA;148091;108;2021-09-21;102371
2021-09-20;"Trenčiansky kraj";78;2612;37;2649;NA;148091;115;2021-09-20;102263
2021-09-19;"Trenčiansky kraj";11;1571;20;1591;NA;148091;31;2021-09-19;102148
2021-09-18;"Trenčiansky kraj";53;2099;14;2113;NA;148091;67;2021-09-18;102117
2021-09-17;"Trenčiansky kraj";55;3143;26;3169;NA;148091;81;2021-09-17;102050
2021-09-16;"Trenčiansky kraj";52;2160;20;2180;NA;148091;72;2021-09-16;101969
2021-09-15;"Trenčiansky kraj";63;1043;7;1050;NA;148091;70;2021-09-15;101897
2021-09-14;"Trenčiansky kraj";67;2449;25;2474;NA;148091;92;2021-09-14;101827
2021-09-13;"Trenčiansky kraj";33;2271;35;2306;NA;148091;68;2021-09-13;101735
2021-09-12;"Trenčiansky kraj";3;1411;11;1422;NA;148091;14;2021-09-12;101667
2021-09-11;"Trenčiansky kraj";55;1729;6;1735;NA;148091;61;2021-09-11;101653
2021-09-10;"Trenčiansky kraj";49;2246;15;2261;NA;148091;64;2021-09-10;101592
2021-09-09;"Trenčiansky kraj";24;1684;30;1714;NA;148091;54;2021-09-09;101528
2021-09-08;"Trenčiansky kraj";54;1770;15;1785;NA;148091;69;2021-09-08;101474
2021-09-07;"Trenčiansky kraj";43;1393;18;1411;NA;148091;61;2021-09-07;101405
2021-09-06;"Trenčiansky kraj";47;1398;15;1413;NA;148091;62;2021-09-06;101344
2021-09-05;"Trenčiansky kraj";2;966;23;989;NA;148091;25;2021-09-05;101282
2021-09-04;"Trenčiansky kraj";41;925;4;929;NA;148091;45;2021-09-04;101257
2021-09-03;"Trenčiansky kraj";53;1421;15;1436;NA;148091;68;2021-09-03;101212
2021-09-02;"Trenčiansky kraj";7;999;14;1013;NA;148091;21;2021-09-02;101144
2021-09-01;"Trenčiansky kraj";27;431;8;439;NA;148091;35;2021-09-01;101123
2021-08-31;"Trenčiansky kraj";21;1146;15;1161;NA;148091;36;2021-08-31;101088
2021-08-30;"Trenčiansky kraj";32;1166;10;1176;NA;148091;42;2021-08-30;101052
2021-08-29;"Trenčiansky kraj";1;482;11;493;NA;148091;12;2021-08-29;101010
2021-08-28;"Trenčiansky kraj";9;976;10;986;NA;148091;19;2021-08-28;100998
2021-08-27;"Trenčiansky kraj";21;1599;1;1600;NA;148091;22;2021-08-27;100979
2021-08-26;"Trenčiansky kraj";8;992;6;998;NA;148091;14;2021-08-26;100957
2021-08-25;"Trenčiansky kraj";40;875;7;882;NA;148091;47;2021-08-25;100943
2021-08-24;"Trenčiansky kraj";4;822;4;826;NA;148091;8;2021-08-24;100896
2021-08-23;"Trenčiansky kraj";6;1165;17;1182;NA;148091;23;2021-08-23;100888
2021-08-22;"Trenčiansky kraj";0;726;10;736;NA;148091;10;2021-08-22;100865
2021-08-21;"Trenčiansky kraj";5;964;7;971;NA;148091;12;2021-08-21;100855
2021-08-20;"Trenčiansky kraj";15;1537;2;1539;NA;148091;17;2021-08-20;100843
2021-08-19;"Trenčiansky kraj";2;985;2;987;NA;148091;4;2021-08-19;100826
2021-08-18;"Trenčiansky kraj";6;814;7;821;NA;148091;13;2021-08-18;100822
2021-08-17;"Trenčiansky kraj";9;633;1;634;NA;148091;10;2021-08-17;100809
2021-08-16;"Trenčiansky kraj";5;925;3;928;NA;148091;8;2021-08-16;100799
2021-08-15;"Trenčiansky kraj";0;558;1;559;NA;148091;1;2021-08-15;100791
2021-08-14;"Trenčiansky kraj";12;574;6;580;NA;148091;18;2021-08-14;100790
2021-08-13;"Trenčiansky kraj";2;933;0;933;NA;148091;2;2021-08-13;100772
2021-08-12;"Trenčiansky kraj";2;564;3;567;NA;148091;5;2021-08-12;100770
2021-08-11;"Trenčiansky kraj";1;680;0;680;NA;148091;1;2021-08-11;100765
2021-08-10;"Trenčiansky kraj";8;530;1;531;NA;148091;9;2021-08-10;100764
2021-08-09;"Trenčiansky kraj";8;694;1;695;NA;148091;9;2021-08-09;100755
2021-08-08;"Trenčiansky kraj";0;468;0;468;NA;148091;0;2021-08-08;100746
2021-08-07;"Trenčiansky kraj";3;464;0;464;NA;148091;3;2021-08-07;100746
2021-08-06;"Trenčiansky kraj";3;955;1;956;NA;148091;4;2021-08-06;100743
2021-08-05;"Trenčiansky kraj";3;579;1;580;NA;148091;4;2021-08-05;100739
2021-08-04;"Trenčiansky kraj";14;546;3;549;NA;148091;17;2021-08-04;100735
2021-08-03;"Trenčiansky kraj";9;508;5;513;NA;148091;14;2021-08-03;100718
2021-08-02;"Trenčiansky kraj";1;807;2;809;NA;148091;3;2021-08-02;100704
2021-08-01;"Trenčiansky kraj";0;458;1;459;NA;148091;1;2021-08-01;100701
2021-07-31;"Trenčiansky kraj";4;525;2;527;NA;148091;6;2021-07-31;100700
2021-07-30;"Trenčiansky kraj";2;1069;0;1069;NA;148091;2;2021-07-30;100694
2021-07-29;"Trenčiansky kraj";5;708;0;708;NA;148091;5;2021-07-29;100692
2021-07-28;"Trenčiansky kraj";3;517;2;519;NA;148091;5;2021-07-28;100687
2021-07-27;"Trenčiansky kraj";6;551;1;552;NA;148091;7;2021-07-27;100682
2021-07-26;"Trenčiansky kraj";7;772;1;773;NA;148091;8;2021-07-26;100675
2021-07-25;"Trenčiansky kraj";0;487;2;489;NA;148091;2;2021-07-25;100667
2021-07-24;"Trenčiansky kraj";3;643;1;644;NA;148091;4;2021-07-24;100665
2021-07-23;"Trenčiansky kraj";3;1151;0;1151;NA;148091;3;2021-07-23;100661
2021-07-22;"Trenčiansky kraj";2;844;2;846;NA;148091;4;2021-07-22;100658
2021-07-21;"Trenčiansky kraj";8;661;2;663;NA;148091;10;2021-07-21;100654
2021-07-20;"Trenčiansky kraj";4;525;1;526;NA;148091;5;2021-07-20;100644
2021-07-19;"Trenčiansky kraj";0;866;4;870;NA;148091;4;2021-07-19;100639
2021-07-18;"Trenčiansky kraj";0;526;0;526;NA;148091;0;2021-07-18;100635
2021-07-17;"Trenčiansky kraj";3;673;0;673;NA;148091;3;2021-07-17;100635
2021-07-16;"Trenčiansky kraj";4;1122;0;1122;NA;148091;4;2021-07-16;100632
2021-07-15;"Trenčiansky kraj";2;824;0;824;NA;148091;2;2021-07-15;100628
2021-07-14;"Trenčiansky kraj";8;645;0;645;NA;148091;8;2021-07-14;100626
2021-07-13;"Trenčiansky kraj";1;520;3;523;NA;148091;4;2021-07-13;100618
2021-07-12;"Trenčiansky kraj";9;820;2;822;NA;148091;11;2021-07-12;100614
2021-07-11;"Trenčiansky kraj";0;611;2;613;NA;148091;2;2021-07-11;100603
2021-07-10;"Trenčiansky kraj";2;535;0;535;NA;148091;2;2021-07-10;100601
2021-07-09;"Trenčiansky kraj";7;1379;0;1379;NA;148091;7;2021-07-09;100599
2021-07-08;"Trenčiansky kraj";2;815;1;816;NA;148091;3;2021-07-08;100592
2021-07-07;"Trenčiansky kraj";2;928;0;928;NA;148091;2;2021-07-07;100589
2021-07-06;"Trenčiansky kraj";4;1041;1;1042;NA;148091;5;2021-07-06;100587
2021-07-05;"Trenčiansky kraj";1;508;0;508;NA;148091;1;2021-07-05;100582
2021-07-04;"Trenčiansky kraj";0;612;1;613;NA;148091;1;2021-07-04;100581
2021-07-03;"Trenčiansky kraj";3;815;1;816;NA;148091;4;2021-07-03;100580
2021-07-02;"Trenčiansky kraj";5;1583;2;1585;NA;148091;7;2021-07-02;100576
2021-07-01;"Trenčiansky kraj";4;1152;1;1153;NA;148091;5;2021-07-01;100569
2021-06-30;"Trenčiansky kraj";2;7021;6;7027;NA;148091;8;2021-06-30;100564
2021-06-29;"Trenčiansky kraj";4;2773;5;2778;NA;148091;9;2021-06-29;100556
2021-06-28;"Trenčiansky kraj";5;3644;4;3648;NA;148091;9;2021-06-28;100547
2021-06-27;"Trenčiansky kraj";0;2861;1;2862;NA;148091;1;2021-06-27;100538
2021-06-26;"Trenčiansky kraj";1;3547;4;3551;NA;148091;5;2021-06-26;100537
2021-06-25;"Trenčiansky kraj";2;4626;1;4627;NA;148091;3;2021-06-25;100532
2021-06-24;"Trenčiansky kraj";3;3320;4;3324;NA;148091;7;2021-06-24;100529
2021-06-23;"Trenčiansky kraj";4;2808;2;2810;NA;148091;6;2021-06-23;100522
2021-06-22;"Trenčiansky kraj";7;3137;4;3141;NA;148091;11;2021-06-22;100516
2021-06-21;"Trenčiansky kraj";10;3891;4;3895;NA;148091;14;2021-06-21;100505
2021-06-20;"Trenčiansky kraj";0;3579;5;3584;NA;148091;5;2021-06-20;100491
2021-06-19;"Trenčiansky kraj";5;4528;1;4529;NA;148091;6;2021-06-19;100486
2021-06-18;"Trenčiansky kraj";7;6725;7;6732;NA;148091;14;2021-06-18;100480
2021-06-17;"Trenčiansky kraj";0;3469;6;3475;NA;148091;6;2021-06-17;100466
2021-06-16;"Trenčiansky kraj";4;3183;3;3186;NA;148091;7;2021-06-16;100460
2021-06-15;"Trenčiansky kraj";10;3697;2;3699;NA;148091;12;2021-06-15;100453
2021-06-14;"Trenčiansky kraj";10;4805;15;4820;NA;148091;25;2021-06-14;100441
2021-06-13;"Trenčiansky kraj";0;4643;4;4647;NA;148091;4;2021-06-13;100416
2021-06-12;"Trenčiansky kraj";4;5260;8;5268;NA;148091;12;2021-06-12;100412
2021-06-11;"Trenčiansky kraj";10;7365;11;7376;NA;148091;21;2021-06-11;100400
2021-06-10;"Trenčiansky kraj";5;4345;7;4352;NA;148091;12;2021-06-10;100379
2021-06-09;"Trenčiansky kraj";7;3693;7;3700;NA;148091;14;2021-06-09;100367
2021-06-08;"Trenčiansky kraj";21;3965;7;3972;NA;148091;28;2021-06-08;100353
2021-06-07;"Trenčiansky kraj";13;5560;10;5570;NA;148091;23;2021-06-07;100325
2021-06-06;"Trenčiansky kraj";0;5500;10;5510;NA;148091;10;2021-06-06;100302
2021-06-05;"Trenčiansky kraj";7;6511;5;6516;NA;148091;12;2021-06-05;100292
2021-06-04;"Trenčiansky kraj";16;7653;3;7656;NA;148091;19;2021-06-04;100280
2021-06-03;"Trenčiansky kraj";9;4485;10;4495;NA;148091;19;2021-06-03;100261
2021-06-02;"Trenčiansky kraj";28;4329;8;4337;NA;148091;36;2021-06-02;100242
2021-06-01;"Trenčiansky kraj";22;5396;18;5414;NA;148091;40;2021-06-01;100206
2021-05-31;"Trenčiansky kraj";30;6117;24;6141;NA;148091;54;2021-05-31;100166
2021-05-30;"Trenčiansky kraj";0;8258;16;8274;NA;148091;16;2021-05-30;100112
2021-05-29;"Trenčiansky kraj";13;7915;14;7929;NA;148091;27;2021-05-29;100096
2021-05-28;"Trenčiansky kraj";22;8995;25;9020;NA;148091;47;2021-05-28;100069
2021-05-27;"Trenčiansky kraj";6;5205;12;5217;NA;148091;18;2021-05-27;100022
2021-05-26;"Trenčiansky kraj";26;5069;15;5084;NA;148091;41;2021-05-26;100004
2021-05-25;"Trenčiansky kraj";18;6168;24;6192;NA;148091;42;2021-05-25;99963
2021-05-24;"Trenčiansky kraj";19;9292;37;9329;NA;148091;56;2021-05-24;99921
2021-05-23;"Trenčiansky kraj";0;9083;26;9109;NA;148091;26;2021-05-23;99865
2021-05-22;"Trenčiansky kraj";11;11314;21;11335;NA;148091;32;2021-05-22;99839
2021-05-21;"Trenčiansky kraj";23;11572;26;11598;NA;148091;49;2021-05-21;99807
2021-05-20;"Trenčiansky kraj";23;6320;25;6345;NA;148091;48;2021-05-20;99758
2021-05-19;"Trenčiansky kraj";16;5694;32;5726;NA;148091;48;2021-05-19;99710
2021-05-18;"Trenčiansky kraj";26;7779;28;7807;NA;148091;54;2021-05-18;99662
2021-05-17;"Trenčiansky kraj";37;7671;43;7714;NA;148091;80;2021-05-17;99608
2021-05-16;"Trenčiansky kraj";25;15615;41;15656;NA;148091;66;2021-05-16;99528
2021-05-15;"Trenčiansky kraj";3;21237;32;21269;NA;148091;35;2021-05-15;99462
2021-05-14;"Trenčiansky kraj";41;18676;42;18718;NA;148091;83;2021-05-14;99427
2021-05-13;"Trenčiansky kraj";41;8195;24;8219;NA;148091;65;2021-05-13;99344
2021-05-12;"Trenčiansky kraj";41;7409;31;7440;NA;148091;72;2021-05-12;99279
2021-05-11;"Trenčiansky kraj";66;10507;32;10539;NA;148091;98;2021-05-11;99207
2021-05-10;"Trenčiansky kraj";48;12989;55;13044;NA;148091;103;2021-05-10;99109
2021-05-09;"Trenčiansky kraj";52;17737;39;17776;NA;148091;91;2021-05-09;99006
2021-05-08;"Trenčiansky kraj";3;23822;33;23855;NA;148091;36;2021-05-08;98915
2021-05-07;"Trenčiansky kraj";45;23549;56;23605;NA;148091;101;2021-05-07;98879
2021-05-06;"Trenčiansky kraj";26;10771;44;10815;NA;148091;70;2021-05-06;98778
2021-05-05;"Trenčiansky kraj";73;9377;41;9418;NA;148091;114;2021-05-05;98708
2021-05-04;"Trenčiansky kraj";55;12733;53;12786;NA;148091;108;2021-05-04;98594
2021-05-03;"Trenčiansky kraj";60;15331;51;15382;NA;148091;111;2021-05-03;98486
2021-05-02;"Trenčiansky kraj";0;31163;65;31228;NA;148091;65;2021-05-02;98375
2021-05-01;"Trenčiansky kraj";71;56982;60;57042;NA;148091;131;2021-05-01;98310
2021-04-30;"Trenčiansky kraj";77;29427;61;29488;NA;148091;138;2021-04-30;98179
2021-04-29;"Trenčiansky kraj";49;13198;59;13257;NA;148091;108;2021-04-29;98041
2021-04-28;"Trenčiansky kraj";79;12537;52;12589;NA;148091;131;2021-04-28;97933
2021-04-27;"Trenčiansky kraj";107;15527;40;15567;NA;148091;147;2021-04-27;97802
2021-04-26;"Trenčiansky kraj";52;21070;63;21133;NA;148091;115;2021-04-26;97655
2021-04-25;"Trenčiansky kraj";0;34560;48;34608;NA;148091;48;2021-04-25;97540
2021-04-24;"Trenčiansky kraj";76;72398;100;72498;NA;148091;176;2021-04-24;97492
2021-04-23;"Trenčiansky kraj";143;29959;79;30038;NA;148091;222;2021-04-23;97316
2021-04-22;"Trenčiansky kraj";71;13847;64;13911;NA;148091;135;2021-04-22;97094
2021-04-21;"Trenčiansky kraj";79;13000;67;13067;NA;148091;146;2021-04-21;96959
2021-04-20;"Trenčiansky kraj";142;17740;80;17820;NA;148091;222;2021-04-20;96813
2021-04-19;"Trenčiansky kraj";102;22631;103;22734;NA;148091;205;2021-04-19;96591
2021-04-18;"Trenčiansky kraj";3;40879;97;40976;NA;148091;100;2021-04-18;96386
2021-04-17;"Trenčiansky kraj";77;81498;136;81634;NA;148091;213;2021-04-17;96286
2021-04-16;"Trenčiansky kraj";100;31961;90;32051;NA;148091;190;2021-04-16;96073
2021-04-15;"Trenčiansky kraj";71;14479;69;14548;NA;148091;140;2021-04-15;95883
2021-04-14;"Trenčiansky kraj";135;15574;72;15646;NA;148091;207;2021-04-14;95743
2021-04-13;"Trenčiansky kraj";189;18721;75;18796;NA;148091;264;2021-04-13;95536
2021-04-12;"Trenčiansky kraj";97;23743;91;23834;NA;148091;188;2021-04-12;95272
2021-04-11;"Trenčiansky kraj";1;34735;75;34810;NA;148091;76;2021-04-11;95084
2021-04-10;"Trenčiansky kraj";81;83093;145;83238;NA;148091;226;2021-04-10;95008
2021-04-09;"Trenčiansky kraj";120;28014;91;28105;NA;148091;211;2021-04-09;94782
2021-04-08;"Trenčiansky kraj";112;13283;85;13368;NA;148091;197;2021-04-08;94571
2021-04-07;"Trenčiansky kraj";204;17688;123;17811;NA;148091;327;2021-04-07;94374
2021-04-06;"Trenčiansky kraj";157;28567;178;28745;NA;148091;335;2021-04-06;94047
2021-04-05;"Trenčiansky kraj";15;9227;64;9291;NA;148091;79;2021-04-05;93712
2021-04-04;"Trenčiansky kraj";2;20291;85;20376;NA;148091;87;2021-04-04;93633
2021-04-03;"Trenčiansky kraj";86;80473;221;80694;NA;148091;307;2021-04-03;93546
2021-04-02;"Trenčiansky kraj";126;21620;81;21701;NA;148091;207;2021-04-02;93239
2021-04-01;"Trenčiansky kraj";159;32376;139;32515;NA;148091;298;2021-04-01;93032
2021-03-31;"Trenčiansky kraj";198;20100;130;20230;NA;148091;328;2021-03-31;92734
2021-03-30;"Trenčiansky kraj";272;17305;136;17441;NA;148091;408;2021-03-30;92406
2021-03-29;"Trenčiansky kraj";142;19479;170;19649;NA;148091;312;2021-03-29;91998
2021-03-28;"Trenčiansky kraj";3;34759;116;34875;NA;148091;119;2021-03-28;91686
2021-03-27;"Trenčiansky kraj";130;77314;293;77607;NA;148091;423;2021-03-27;91567
2021-03-26;"Trenčiansky kraj";211;35095;157;35252;NA;148091;368;2021-03-26;91144
2021-03-25;"Trenčiansky kraj";184;16580;176;16756;NA;148091;360;2021-03-25;90776
2021-03-24;"Trenčiansky kraj";259;13102;171;13273;NA;148091;430;2021-03-24;90416
2021-03-23;"Trenčiansky kraj";349;17589;174;17763;NA;148091;523;2021-03-23;89986
2021-03-22;"Trenčiansky kraj";141;21116;213;21329;NA;148091;354;2021-03-22;89463
2021-03-21;"Trenčiansky kraj";85;32711;164;32875;NA;148091;249;2021-03-21;89109
2021-03-20;"Trenčiansky kraj";128;80035;322;80357;NA;148091;450;2021-03-20;88860
2021-03-19;"Trenčiansky kraj";231;34783;232;35015;NA;148091;463;2021-03-19;88410
2021-03-18;"Trenčiansky kraj";262;16105;178;16283;NA;148091;440;2021-03-18;87947
2021-03-17;"Trenčiansky kraj";366;13435;164;13599;NA;148091;530;2021-03-17;87507
2021-03-16;"Trenčiansky kraj";450;15282;241;15523;NA;148091;691;2021-03-16;86977
2021-03-15;"Trenčiansky kraj";162;21235;261;21496;NA;148091;423;2021-03-15;86286
2021-03-14;"Trenčiansky kraj";42;34416;238;34654;NA;148091;280;2021-03-14;85863
2021-03-13;"Trenčiansky kraj";270;79186;453;79639;NA;148091;723;2021-03-13;85583
2021-03-12;"Trenčiansky kraj";366;34795;307;35102;NA;148091;673;2021-03-12;84860
2021-03-11;"Trenčiansky kraj";302;15558;213;15771;NA;148091;515;2021-03-11;84187
2021-03-10;"Trenčiansky kraj";402;13585;237;13822;NA;148091;639;2021-03-10;83672
2021-03-09;"Trenčiansky kraj";586;17982;285;18267;NA;148091;871;2021-03-09;83033
2021-03-08;"Trenčiansky kraj";174;21704;363;22067;NA;148091;537;2021-03-08;82162
2021-03-07;"Trenčiansky kraj";4;33660;313;33973;NA;148091;317;2021-03-07;81625
2021-03-06;"Trenčiansky kraj";260;79661;529;80190;NA;148091;789;2021-03-06;81308
2021-03-05;"Trenčiansky kraj";326;32960;416;33376;NA;148091;742;2021-03-05;80519
2021-03-04;"Trenčiansky kraj";323;16821;317;17138;NA;148091;640;2021-03-04;79777
2021-03-03;"Trenčiansky kraj";413;13960;347;14307;NA;148091;760;2021-03-03;79137
2021-03-02;"Trenčiansky kraj";612;17794;344;18138;NA;148091;956;2021-03-02;78377
2021-03-01;"Trenčiansky kraj";217;21104;445;21549;NA;148091;662;2021-03-01;77421
2021-02-28;"Trenčiansky kraj";45;30238;376;30614;NA;148091;421;2021-02-28;76759
2021-02-27;"Trenčiansky kraj";277;78735;686;79421;NA;148091;963;2021-02-27;76338
2021-02-26;"Trenčiansky kraj";420;32944;435;33379;NA;148091;855;2021-02-26;75375
2021-02-25;"Trenčiansky kraj";424;14029;328;14357;NA;148091;752;2021-02-25;74520
2021-02-24;"Trenčiansky kraj";427;11997;398;12395;NA;148091;825;2021-02-24;73768
2021-02-23;"Trenčiansky kraj";577;14904;390;15294;NA;148091;967;2021-02-23;72943
2021-02-22;"Trenčiansky kraj";160;19969;468;20437;NA;148091;628;2021-02-22;71976
2021-02-21;"Trenčiansky kraj";64;29478;392;29870;NA;148091;456;2021-02-21;71348
2021-02-20;"Trenčiansky kraj";274;77840;745;78585;NA;148091;1019;2021-02-20;70892
2021-02-19;"Trenčiansky kraj";272;30266;523;30789;NA;148091;795;2021-02-19;69873
2021-02-18;"Trenčiansky kraj";355;14094;403;14497;NA;148091;758;2021-02-18;69078
2021-02-17;"Trenčiansky kraj";363;11413;377;11790;NA;148091;740;2021-02-17;68320
2021-02-16;"Trenčiansky kraj";488;17761;406;18167;NA;148091;894;2021-02-16;67580
2021-02-15;"Trenčiansky kraj";151;21846;463;22309;NA;148091;614;2021-02-15;66686
2021-02-14;"Trenčiansky kraj";2;31255;324;31579;NA;148091;326;2021-02-14;66072
2021-02-13;"Trenčiansky kraj";274;63006;522;63528;NA;148091;796;2021-02-13;65746
2021-02-12;"Trenčiansky kraj";276;27979;412;28391;NA;148091;688;2021-02-12;64950
2021-02-11;"Trenčiansky kraj";291;11567;323;11890;NA;148091;614;2021-02-11;64262
2021-02-10;"Trenčiansky kraj";304;11408;317;11725;NA;148091;621;2021-02-10;63648
2021-02-09;"Trenčiansky kraj";514;18412;360;18772;NA;148091;874;2021-02-09;63027
2021-02-08;"Trenčiansky kraj";182;26832;430;27262;NA;148091;612;2021-02-08;62153
2021-02-07;"Trenčiansky kraj";31;36781;341;37122;NA;148091;372;2021-02-07;61541
2021-02-06;"Trenčiansky kraj";216;63931;560;64491;NA;148091;776;2021-02-06;61169
2021-02-05;"Trenčiansky kraj";202;18164;367;18531;NA;148091;569;2021-02-05;60393
2021-02-04;"Trenčiansky kraj";266;7253;311;7564;NA;148091;577;2021-02-04;59824
2021-02-03;"Trenčiansky kraj";162;6723;320;7043;NA;148091;482;2021-02-03;59247
2021-02-02;"Trenčiansky kraj";347;8074;381;8455;NA;148091;728;2021-02-02;58765
2021-02-01;"Trenčiansky kraj";167;8921;311;9232;NA;148091;478;2021-02-01;58037
2021-01-31;"Trenčiansky kraj";7;19103;159;19262;NA;148091;166;2021-01-31;57559
2021-01-30;"Trenčiansky kraj";228;38167;332;38499;NA;148091;560;2021-01-30;57393
2021-01-29;"Trenčiansky kraj";214;7590;235;7825;NA;148091;449;2021-01-29;56833
2021-01-28;"Trenčiansky kraj";307;5442;158;5600;NA;148091;465;2021-01-28;56384
2021-01-27;"Trenčiansky kraj";166;4842;181;5023;NA;148091;347;2021-01-27;55919
2021-01-26;"Trenčiansky kraj";303;14589;250;14839;NA;148091;553;2021-01-26;55572
2021-01-25;"Trenčiansky kraj";160;24310;207;24517;NA;148091;367;2021-01-25;55019
2021-01-24;"Trenčiansky kraj";51;38369;282;38651;NA;148091;333;2021-01-24;54652
2021-01-23;"Trenčiansky kraj";206;114125;749;114874;NA;148091;955;2021-01-23;54319
2021-01-22;"Trenčiansky kraj";148;21831;241;22072;NA;148091;389;2021-01-22;53364
2021-01-21;"Trenčiansky kraj";143;8586;166;8752;NA;148091;309;2021-01-21;52975
2021-01-20;"Trenčiansky kraj";181;8189;227;8416;NA;148091;408;2021-01-20;52666
2021-01-19;"Trenčiansky kraj";363;6600;262;6862;NA;148091;625;2021-01-19;52258
2021-01-18;"Trenčiansky kraj";72;4970;321;5291;NA;148091;393;2021-01-18;51633
2021-01-17;"Trenčiansky kraj";124;156;11;167;NA;148091;135;2021-01-17;51240
2021-01-16;"Trenčiansky kraj";39;1288;53;1341;NA;148091;92;2021-01-16;51105
2021-01-15;"Trenčiansky kraj";264;4031;214;4245;NA;148091;478;2021-01-15;51013
2021-01-14;"Trenčiansky kraj";275;3193;189;3382;NA;148091;464;2021-01-14;50535
2021-01-13;"Trenčiansky kraj";222;3893;215;4108;NA;148091;437;2021-01-13;50071
2021-01-12;"Trenčiansky kraj";508;4604;261;4865;NA;148091;769;2021-01-12;49634
2021-01-11;"Trenčiansky kraj";142;4367;354;4721;NA;148091;496;2021-01-11;48865
2021-01-10;"Trenčiansky kraj";89;4969;77;5046;NA;148091;166;2021-01-10;48369
2021-01-09;"Trenčiansky kraj";276;8280;128;8408;NA;148091;404;2021-01-09;48203
2021-01-08;"Trenčiansky kraj";489;6435;484;6919;NA;148091;973;2021-01-08;47799
2021-01-07;"Trenčiansky kraj";420;6138;577;6715;NA;148091;997;2021-01-07;46826
2021-01-06;"Trenčiansky kraj";221;1021;64;1085;NA;148091;285;2021-01-06;45829
2021-01-05;"Trenčiansky kraj";669;5753;706;6459;NA;148091;1375;2021-01-05;45544
2021-01-04;"Trenčiansky kraj";337;5248;782;6030;NA;148091;1119;2021-01-04;44169
2021-01-03;"Trenčiansky kraj";38;114;15;129;NA;148091;53;2021-01-03;43050
2021-01-02;"Trenčiansky kraj";129;196;23;219;NA;148091;152;2021-01-02;42997
2021-01-01;"Trenčiansky kraj";329;347;23;370;NA;148091;352;2021-01-01;42845
2020-12-31;"Trenčiansky kraj";597;4943;557;5500;NA;148091;1154;2020-12-31;42493
2020-12-30;"Trenčiansky kraj";836;7012;762;7774;NA;148091;1598;2020-12-30;41339
2020-12-29;"Trenčiansky kraj";459;6121;1009;7130;NA;148091;1468;2020-12-29;39741
2020-12-28;"Trenčiansky kraj";258;4195;777;4972;NA;148091;1035;2020-12-28;38273
2020-12-27;"Trenčiansky kraj";5;208;36;244;NA;148091;41;2020-12-27;37238
2020-12-26;"Trenčiansky kraj";174;74;10;84;NA;148091;184;2020-12-26;37197
2020-12-25;"Trenčiansky kraj";251;325;47;372;NA;148091;298;2020-12-25;37013
2020-12-24;"Trenčiansky kraj";552;2194;256;2450;NA;148091;808;2020-12-24;36715
2020-12-23;"Trenčiansky kraj";421;6552;661;7213;NA;148091;1082;2020-12-23;35907
2020-12-22;"Trenčiansky kraj";673;5760;694;6454;NA;148091;1367;2020-12-22;34825
2020-12-21;"Trenčiansky kraj";248;13395;979;14374;NA;148091;1227;2020-12-21;33458
2020-12-20;"Trenčiansky kraj";238;12504;292;12796;NA;148091;530;2020-12-20;32231
2020-12-19;"Trenčiansky kraj";341;1611;150;1761;NA;148091;491;2020-12-19;31701
2020-12-18;"Trenčiansky kraj";521;5199;615;5814;NA;148091;1136;2020-12-18;31210
2020-12-17;"Trenčiansky kraj";670;3843;524;4367;NA;148091;1194;2020-12-17;30074
2020-12-16;"Trenčiansky kraj";461;4474;648;5122;NA;148091;1109;2020-12-16;28880
2020-12-15;"Trenčiansky kraj";595;3805;670;4475;NA;148091;1265;2020-12-15;27771
2020-12-14;"Trenčiansky kraj";318;2907;552;3459;NA;148091;870;2020-12-14;26506
2020-12-13;"Trenčiansky kraj";77;49;6;55;NA;148091;83;2020-12-13;25636
2020-12-12;"Trenčiansky kraj";314;1191;136;1327;NA;148091;450;2020-12-12;25553
2020-12-11;"Trenčiansky kraj";751;3773;453;4226;NA;148091;1204;2020-12-11;25103
2020-12-10;"Trenčiansky kraj";271;3354;473;3827;NA;148091;744;2020-12-10;23899
2020-12-09;"Trenčiansky kraj";508;3788;466;4254;NA;148091;974;2020-12-09;23155
2020-12-08;"Trenčiansky kraj";546;3440;522;3962;NA;148091;1068;2020-12-08;22181
2020-12-07;"Trenčiansky kraj";258;3832;468;4300;NA;148091;726;2020-12-07;21113
2020-12-06;"Trenčiansky kraj";114;179;10;189;NA;148091;124;2020-12-06;20387
2020-12-05;"Trenčiansky kraj";223;610;56;666;NA;148091;279;2020-12-05;20263
2020-12-04;"Trenčiansky kraj";253;2943;273;3216;NA;148091;526;2020-12-04;19984
2020-12-03;"Trenčiansky kraj";503;1714;178;1892;NA;148091;681;2020-12-03;19458
2020-12-02;"Trenčiansky kraj";418;1844;232;2076;NA;148091;650;2020-12-02;18777
2020-12-01;"Trenčiansky kraj";321;5642;351;5993;NA;148091;672;2020-12-01;18127
2020-11-30;"Trenčiansky kraj";167;11514;520;12034;NA;148091;687;2020-11-30;17455
2020-11-29;"Trenčiansky kraj";29;30;5;35;NA;148091;34;2020-11-29;16768
2020-11-28;"Trenčiansky kraj";202;1051;93;1144;NA;148091;295;2020-11-28;16734
2020-11-27;"Trenčiansky kraj";330;1888;186;2074;NA;148091;516;2020-11-27;16439
2020-11-26;"Trenčiansky kraj";395;1252;122;1374;NA;148091;517;2020-11-26;15923
2020-11-25;"Trenčiansky kraj";322;1444;160;1604;NA;148091;482;2020-11-25;15406
2020-11-24;"Trenčiansky kraj";348;2553;308;2861;NA;148091;656;2020-11-24;14924
2020-11-23;"Trenčiansky kraj";159;1186;122;1308;NA;148091;281;2020-11-23;14268
2020-11-22;"Trenčiansky kraj";26;30;7;37;NA;148091;33;2020-11-22;13987
2020-11-21;"Trenčiansky kraj";255;1376;69;1445;NA;148091;324;2020-11-21;13954
2020-11-20;"Trenčiansky kraj";316;861;93;954;NA;148091;409;2020-11-20;13630
2020-11-19;"Trenčiansky kraj";316;740;113;853;NA;148091;429;2020-11-19;13221
2020-11-18;"Trenčiansky kraj";233;379;66;445;NA;148091;299;2020-11-18;12792
2020-11-17;"Trenčiansky kraj";222;106;15;121;NA;148091;237;2020-11-17;12493
2020-11-16;"Trenčiansky kraj";245;236;45;281;NA;148091;290;2020-11-16;12256
2020-11-15;"Trenčiansky kraj";109;29;6;35;NA;148091;115;2020-11-15;11966
2020-11-14;"Trenčiansky kraj";190;74;11;85;NA;148091;201;2020-11-14;11851
2020-11-13;"Trenčiansky kraj";308;131;13;144;NA;148091;321;2020-11-13;11650
2020-11-12;"Trenčiansky kraj";324;124;5;129;NA;148091;329;2020-11-12;11329
2020-11-11;"Trenčiansky kraj";366;113;10;123;NA;148091;376;2020-11-11;11000
2020-11-10;"Trenčiansky kraj";277;106;6;112;NA;148091;283;2020-11-10;10624
2020-11-09;"Trenčiansky kraj";115;1407;48;1455;NA;148091;163;2020-11-09;10341
2020-11-08;"Trenčiansky kraj";81;1271;8;1279;NA;148091;89;2020-11-08;10178
2020-11-07;"Trenčiansky kraj";319;3662;59;3721;NA;148091;378;2020-11-07;10089
2020-11-06;"Trenčiansky kraj";383;6893;84;6977;NA;148091;467;2020-11-06;9711
2020-11-05;"Trenčiansky kraj";399;98;15;113;NA;148091;414;2020-11-05;9244
2020-11-04;"Trenčiansky kraj";370;91;9;100;NA;148091;379;2020-11-04;8830
2020-11-03;"Trenčiansky kraj";575;97;8;105;NA;148091;583;2020-11-03;8451
2020-11-02;"Trenčiansky kraj";197;1833;68;1901;NA;148091;265;2020-11-02;7868
2020-11-01;"Trenčiansky kraj";257;808;24;832;NA;148091;281;2020-11-01;7603
2020-10-31;"Trenčiansky kraj";332;4719;82;4801;NA;148091;414;2020-10-31;7322
2020-10-30;"Trenčiansky kraj";299;5283;102;5385;NA;148091;401;2020-10-30;6908
2020-10-29;"Trenčiansky kraj";496;764;68;832;NA;148091;564;2020-10-29;6507
2020-10-28;"Trenčiansky kraj";269;192;33;225;NA;148091;302;2020-10-28;5943
2020-10-27;"Trenčiansky kraj";473;127;27;154;NA;148091;500;2020-10-27;5641
2020-10-26;"Trenčiansky kraj";177;107;36;143;NA;148091;213;2020-10-26;5141
2020-10-25;"Trenčiansky kraj";138;9;5;14;NA;148091;143;2020-10-25;4928
2020-10-24;"Trenčiansky kraj";395;128;6;134;NA;148091;401;2020-10-24;4785
2020-10-23;"Trenčiansky kraj";301;154;8;162;NA;148091;309;2020-10-23;4384
2020-10-22;"Trenčiansky kraj";273;82;12;94;NA;148091;285;2020-10-22;4075
2020-10-21;"Trenčiansky kraj";183;53;9;62;NA;148091;192;2020-10-21;3790
2020-10-20;"Trenčiansky kraj";212;47;6;53;NA;148091;218;2020-10-20;3598
2020-10-19;"Trenčiansky kraj";41;83;25;108;NA;148091;66;2020-10-19;3380
2020-10-18;"Trenčiansky kraj";104;0;0;0;NA;148091;104;2020-10-18;3314
2020-10-17;"Trenčiansky kraj";157;0;0;0;NA;148091;157;2020-10-17;3210
2020-10-16;"Trenčiansky kraj";225;42;6;48;NA;148091;231;2020-10-16;3053
2020-10-15;"Trenčiansky kraj";255;39;4;43;NA;148091;259;2020-10-15;2822
2020-10-14;"Trenčiansky kraj";162;42;7;49;NA;148091;169;2020-10-14;2563
2020-10-13;"Trenčiansky kraj";124;105;12;117;NA;148091;136;2020-10-13;2394
2020-10-12;"Trenčiansky kraj";55;0;0;0;NA;148091;55;2020-10-12;2258
2020-10-11;"Trenčiansky kraj";73;0;0;0;NA;148091;73;2020-10-11;2203
2020-10-10;"Trenčiansky kraj";180;0;0;0;NA;148091;180;2020-10-10;2130
2020-10-09;"Trenčiansky kraj";198;0;0;0;NA;148091;198;2020-10-09;1950
2020-10-08;"Trenčiansky kraj";115;0;0;0;NA;148091;115;2020-10-08;1752
2020-10-07;"Trenčiansky kraj";75;0;0;0;NA;148091;75;2020-10-07;1637
2020-10-06;"Trenčiansky kraj";72;0;0;0;NA;148091;72;2020-10-06;1562
2020-10-05;"Trenčiansky kraj";32;0;0;0;NA;148091;32;2020-10-05;1490
2020-10-04;"Trenčiansky kraj";37;0;0;0;NA;148091;37;2020-10-04;1458
2020-10-03;"Trenčiansky kraj";79;0;0;0;NA;148091;79;2020-10-03;1421
2020-10-02;"Trenčiansky kraj";69;0;0;0;NA;148091;69;2020-10-02;1342
2020-10-01;"Trenčiansky kraj";58;0;0;0;NA;148091;58;2020-10-01;1273
2020-09-30;"Trenčiansky kraj";76;0;0;0;NA;148091;76;2020-09-30;1215
2020-09-29;"Trenčiansky kraj";43;0;0;0;NA;148091;43;2020-09-29;1139
2020-09-28;"Trenčiansky kraj";7;0;0;0;NA;148091;7;2020-09-28;1096
2020-09-27;"Trenčiansky kraj";12;0;0;0;NA;148091;12;2020-09-27;1089
2020-09-26;"Trenčiansky kraj";37;0;0;0;NA;148091;37;2020-09-26;1077
2020-09-25;"Trenčiansky kraj";72;0;0;0;NA;148091;72;2020-09-25;1040
2020-09-24;"Trenčiansky kraj";41;0;0;0;NA;148091;41;2020-09-24;968
2020-09-23;"Trenčiansky kraj";32;0;0;0;NA;148091;32;2020-09-23;927
2020-09-22;"Trenčiansky kraj";26;0;0;0;NA;148091;26;2020-09-22;895
2020-09-21;"Trenčiansky kraj";23;0;0;0;NA;148091;23;2020-09-21;869
2020-09-20;"Trenčiansky kraj";21;0;0;0;NA;148091;21;2020-09-20;846
2020-09-19;"Trenčiansky kraj";20;0;0;0;NA;148091;20;2020-09-19;825
2020-09-18;"Trenčiansky kraj";41;0;0;0;NA;148091;41;2020-09-18;805
2020-09-17;"Trenčiansky kraj";20;0;0;0;NA;148091;20;2020-09-17;764
2020-09-16;"Trenčiansky kraj";14;0;0;0;NA;148091;14;2020-09-16;744
2020-09-15;"Trenčiansky kraj";8;0;0;0;NA;148091;8;2020-09-15;730
2020-09-14;"Trenčiansky kraj";5;0;0;0;NA;148091;5;2020-09-14;722
2020-09-13;"Trenčiansky kraj";12;0;0;0;NA;148091;12;2020-09-13;717
2020-09-12;"Trenčiansky kraj";2;0;0;0;NA;148091;2;2020-09-12;705
2020-09-11;"Trenčiansky kraj";27;0;0;0;NA;148091;27;2020-09-11;703
2020-09-10;"Trenčiansky kraj";15;0;0;0;NA;148091;15;2020-09-10;676
2020-09-09;"Trenčiansky kraj";11;0;0;0;NA;148091;11;2020-09-09;661
2020-09-08;"Trenčiansky kraj";12;0;0;0;NA;148091;12;2020-09-08;650
2020-09-07;"Trenčiansky kraj";6;0;0;0;NA;148091;6;2020-09-07;638
2020-09-06;"Trenčiansky kraj";1;0;0;0;NA;148091;1;2020-09-06;632
2020-09-05;"Trenčiansky kraj";3;0;0;0;NA;148091;3;2020-09-05;631
2020-09-04;"Trenčiansky kraj";9;0;0;0;NA;148091;9;2020-09-04;628
2020-09-03;"Trenčiansky kraj";10;0;0;0;NA;148091;10;2020-09-03;619
2020-09-02;"Trenčiansky kraj";5;0;0;0;NA;148091;5;2020-09-02;609
2020-09-01;"Trenčiansky kraj";1;0;0;0;NA;148091;1;2020-09-01;604
2020-08-31;"Trenčiansky kraj";12;0;0;0;NA;148091;12;2020-08-31;603
2020-08-30;"Trenčiansky kraj";0;0;0;0;NA;148091;0;2020-08-30;591
2020-08-29;"Trenčiansky kraj";1;0;0;0;NA;148091;1;2020-08-29;591
2020-08-28;"Trenčiansky kraj";12;0;0;0;NA;148091;12;2020-08-28;590
2020-08-27;"Trenčiansky kraj";10;0;0;0;NA;148091;10;2020-08-27;578
2020-08-26;"Trenčiansky kraj";15;0;0;0;NA;148091;15;2020-08-26;568
2020-08-25;"Trenčiansky kraj";12;0;0;0;NA;148091;12;2020-08-25;553
2020-08-24;"Trenčiansky kraj";4;0;0;0;NA;148091;4;2020-08-24;541
2020-08-23;"Trenčiansky kraj";5;0;0;0;NA;148091;5;2020-08-23;537
2020-08-22;"Trenčiansky kraj";6;0;0;0;NA;148091;6;2020-08-22;532
2020-08-21;"Trenčiansky kraj";6;0;0;0;NA;148091;6;2020-08-21;526
2020-08-20;"Trenčiansky kraj";20;0;0;0;NA;148091;20;2020-08-20;520
2020-08-19;"Trenčiansky kraj";17;0;0;0;NA;148091;17;2020-08-19;500
2020-08-18;"Trenčiansky kraj";9;0;0;0;NA;148091;9;2020-08-18;483
2020-08-17;"Trenčiansky kraj";4;0;0;0;NA;148091;4;2020-08-17;474
2020-08-16;"Trenčiansky kraj";0;0;0;0;NA;148091;0;2020-08-16;470
2020-08-15;"Trenčiansky kraj";9;0;0;0;NA;148091;9;2020-08-15;470
2020-08-14;"Trenčiansky kraj";15;0;0;0;NA;148091;15;2020-08-14;461
2020-08-13;"Trenčiansky kraj";23;0;0;0;NA;148091;23;2020-08-13;446
2020-08-12;"Trenčiansky kraj";6;0;0;0;NA;148091;6;2020-08-12;423
2020-08-11;"Trenčiansky kraj";7;0;0;0;NA;148091;7;2020-08-11;417
2020-08-10;"Trenčiansky kraj";9;0;0;0;NA;148091;9;2020-08-10;410
2020-08-09;"Trenčiansky kraj";1;0;0;0;NA;148091;1;2020-08-09;401
2020-08-08;"Trenčiansky kraj";4;0;0;0;NA;148091;4;2020-08-08;400
2020-08-07;"Trenčiansky kraj";4;0;0;0;NA;148091;4;2020-08-07;396
2020-08-06;"Trenčiansky kraj";13;0;0;0;NA;148091;13;2020-08-06;392
2020-08-05;"Trenčiansky kraj";39;0;0;0;NA;148091;39;2020-08-05;379
2020-08-04;"Trenčiansky kraj";9;0;0;0;NA;148091;9;2020-08-04;340
2020-08-03;"Trenčiansky kraj";0;0;0;0;NA;148091;0;2020-08-03;331
2020-08-02;"Trenčiansky kraj";2;0;0;0;NA;148091;2;2020-08-02;331
2020-08-01;"Trenčiansky kraj";6;0;0;0;NA;148091;6;2020-08-01;329
2020-07-31;"Trenčiansky kraj";16;0;0;0;NA;148091;16;2020-07-31;323
2020-07-30;"Trenčiansky kraj";4;0;0;0;NA;148091;4;2020-07-30;307
2020-07-29;"Trenčiansky kraj";5;0;0;0;NA;148091;5;2020-07-29;303
2020-07-28;"Trenčiansky kraj";11;0;0;0;NA;148091;11;2020-07-28;298
2020-07-27;"Trenčiansky kraj";4;0;0;0;NA;148091;4;2020-07-27;287
2020-07-26;"Trenčiansky kraj";1;0;0;0;NA;148091;1;2020-07-26;283
2020-07-25;"Trenčiansky kraj";7;0;0;0;NA;148091;7;2020-07-25;282
2020-07-24;"Trenčiansky kraj";5;0;0;0;NA;148091;5;2020-07-24;275
2020-07-23;"Trenčiansky kraj";10;0;0;0;NA;148091;10;2020-07-23;270
2020-07-22;"Trenčiansky kraj";11;0;0;0;NA;148091;11;2020-07-22;260
2020-07-21;"Trenčiansky kraj";6;0;0;0;NA;148091;6;2020-07-21;249
2020-07-20;"Trenčiansky kraj";13;0;0;0;NA;148091;13;2020-07-20;243
2020-07-19;"Trenčiansky kraj";0;0;0;0;NA;148091;0;2020-07-19;230
2020-07-18;"Trenčiansky kraj";0;0;0;0;NA;148091;0;2020-07-18;230
2020-07-17;"Trenčiansky kraj";1;0;0;0;NA;148091;1;2020-07-17;230
2020-07-16;"Trenčiansky kraj";0;0;0;0;NA;148091;0;2020-07-16;229
2020-07-15;"Trenčiansky kraj";2;0;0;0;NA;148091;2;2020-07-15;229
2020-07-14;"Trenčiansky kraj";8;0;0;0;NA;148091;8;2020-07-14;227
2020-07-13;"Trenčiansky kraj";1;0;0;0;NA;148091;1;2020-07-13;219
2020-07-12;"Trenčiansky kraj";0;0;0;0;NA;148091;0;2020-07-12;218
2020-07-11;"Trenčiansky kraj";0;0;0;0;NA;148091;0;2020-07-11;218
2020-07-10;"Trenčiansky kraj";3;0;0;0;NA;148091;3;2020-07-10;218
2020-07-09;"Trenčiansky kraj";2;0;0;0;NA;148091;2;2020-07-09;215
2020-07-08;"Trenčiansky kraj";1;0;0;0;NA;148091;1;2020-07-08;213
2020-07-07;"Trenčiansky kraj";9;0;0;0;NA;148091;9;2020-07-07;212
2020-07-06;"Trenčiansky kraj";1;0;0;0;NA;148091;1;2020-07-06;203
2020-07-05;"Trenčiansky kraj";1;0;0;0;NA;148091;1;2020-07-05;202
2020-07-04;"Trenčiansky kraj";0;0;0;0;NA;148091;0;2020-07-04;201
2020-07-03;"Trenčiansky kraj";2;0;0;0;NA;148091;2;2020-07-03;201
2020-07-02;"Trenčiansky kraj";10;0;0;0;NA;148091;10;2020-07-02;199
2020-07-01;"Trenčiansky kraj";1;0;0;0;NA;148091;1;2020-07-01;189
2020-06-30;"Trenčiansky kraj";6;0;0;0;NA;148091;6;2020-06-30;188
2020-06-29;"Trenčiansky kraj";1;0;0;0;NA;148091;1;2020-06-29;182
2020-06-28;"Trenčiansky kraj";0;0;0;0;NA;148091;0;2020-06-28;181
2020-06-27;"Trenčiansky kraj";0;0;0;0;NA;148091;0;2020-06-27;181
2020-06-26;"Trenčiansky kraj";0;0;0;0;NA;148091;0;2020-06-26;181
2020-06-25;"Trenčiansky kraj";2;0;0;0;NA;148091;2;2020-06-25;181
2020-06-24;"Trenčiansky kraj";1;0;0;0;NA;148091;1;2020-06-24;179
2020-06-23;"Trenčiansky kraj";0;0;0;0;NA;148091;0;2020-06-23;178
2020-06-22;"Trenčiansky kraj";0;0;0;0;NA;148091;0;2020-06-22;178
2020-06-21;"Trenčiansky kraj";0;0;0;0;NA;148091;0;2020-06-21;178
2020-06-20;"Trenčiansky kraj";0;0;0;0;NA;148091;0;2020-06-20;178
2020-06-19;"Trenčiansky kraj";0;0;0;0;NA;148091;0;2020-06-19;178
2020-06-18;"Trenčiansky kraj";0;0;0;0;NA;148091;0;2020-06-18;178
2020-06-17;"Trenčiansky kraj";0;0;0;0;NA;148091;0;2020-06-17;178
2020-06-16;"Trenčiansky kraj";0;0;0;0;NA;148091;0;2020-06-16;178
2020-06-14;"Trenčiansky kraj";0;0;0;0;NA;148091;0;2020-06-14;178
2020-06-13;"Trenčiansky kraj";0;0;0;0;NA;148091;0;2020-06-13;178
2020-06-12;"Trenčiansky kraj";0;0;0;0;NA;148091;0;2020-06-12;178
2020-06-11;"Trenčiansky kraj";0;0;0;0;NA;148091;0;2020-06-11;178
2020-06-10;"Trenčiansky kraj";1;0;0;0;NA;148091;1;2020-06-10;178
2020-06-09;"Trenčiansky kraj";0;0;0;0;NA;148091;0;2020-06-09;177
2020-06-08;"Trenčiansky kraj";0;0;0;0;NA;148091;0;2020-06-08;177
2020-06-07;"Trenčiansky kraj";0;0;0;0;NA;148091;0;2020-06-07;177
2020-06-05;"Trenčiansky kraj";0;0;0;0;NA;148091;0;2020-06-05;177
2020-06-03;"Trenčiansky kraj";0;0;0;0;NA;148091;0;2020-06-03;177
2020-06-02;"Trenčiansky kraj";0;0;0;0;NA;148091;0;2020-06-02;177
2020-05-31;"Trenčiansky kraj";0;0;0;0;NA;148091;0;2020-05-31;177
2020-05-29;"Trenčiansky kraj";0;0;0;0;NA;148091;0;2020-05-29;177
2020-05-27;"Trenčiansky kraj";2;0;0;0;NA;148091;2;2020-05-27;177
2020-05-26;"Trenčiansky kraj";0;0;0;0;NA;148091;0;2020-05-26;175
2020-05-25;"Trenčiansky kraj";0;0;0;0;NA;148091;0;2020-05-25;175
2020-05-24;"Trenčiansky kraj";0;0;0;0;NA;148091;0;2020-05-24;175
2020-05-23;"Trenčiansky kraj";0;0;0;0;NA;148091;0;2020-05-23;175
2020-05-22;"Trenčiansky kraj";0;0;0;0;NA;148091;0;2020-05-22;175
2020-05-21;"Trenčiansky kraj";0;0;0;0;NA;148091;0;2020-05-21;175
2020-05-20;"Trenčiansky kraj";0;0;0;0;NA;148091;0;2020-05-20;175
2020-05-19;"Trenčiansky kraj";0;0;0;0;NA;148091;0;2020-05-19;175
2020-05-17;"Trenčiansky kraj";0;0;0;0;NA;148091;0;2020-05-17;175
2020-05-16;"Trenčiansky kraj";0;0;0;0;NA;148091;0;2020-05-16;175
2020-05-15;"Trenčiansky kraj";1;0;0;0;NA;148091;1;2020-05-15;175
2020-05-14;"Trenčiansky kraj";2;0;0;0;NA;148091;2;2020-05-14;174
2020-05-13;"Trenčiansky kraj";1;0;0;0;NA;148091;1;2020-05-13;172
2020-05-12;"Trenčiansky kraj";1;0;0;0;NA;148091;1;2020-05-12;171
2020-05-11;"Trenčiansky kraj";3;0;0;0;NA;148091;3;2020-05-11;170
2020-05-09;"Trenčiansky kraj";2;0;0;0;NA;148091;2;2020-05-09;167
2020-05-07;"Trenčiansky kraj";6;0;0;0;NA;148091;6;2020-05-07;165
2020-05-06;"Trenčiansky kraj";0;0;0;0;NA;148091;0;2020-05-06;159
2020-05-05;"Trenčiansky kraj";2;0;0;0;NA;148091;2;2020-05-05;159
2020-05-04;"Trenčiansky kraj";0;0;0;0;NA;148091;0;2020-05-04;157
2020-05-03;"Trenčiansky kraj";0;0;0;0;NA;148091;0;2020-05-03;157
2020-05-02;"Trenčiansky kraj";0;0;0;0;NA;148091;0;2020-05-02;157
2020-05-01;"Trenčiansky kraj";0;0;0;0;NA;148091;0;2020-05-01;157
2020-04-30;"Trenčiansky kraj";0;0;0;0;NA;148091;0;2020-04-30;157
2020-04-29;"Trenčiansky kraj";2;0;0;0;NA;148091;2;2020-04-29;157
2020-04-28;"Trenčiansky kraj";1;0;0;0;NA;148091;1;2020-04-28;155
2020-04-27;"Trenčiansky kraj";0;0;0;0;NA;148091;0;2020-04-27;154
2020-04-26;"Trenčiansky kraj";1;0;0;0;NA;148091;1;2020-04-26;154
2020-04-25;"Trenčiansky kraj";0;0;0;0;NA;148091;0;2020-04-25;153
2020-04-24;"Trenčiansky kraj";0;0;0;0;NA;148091;0;2020-04-24;153
2020-04-23;"Trenčiansky kraj";11;0;0;0;NA;148091;11;2020-04-23;153
2020-04-22;"Trenčiansky kraj";1;0;0;0;NA;148091;1;2020-04-22;142
2020-04-21;"Trenčiansky kraj";11;0;0;0;NA;148091;11;2020-04-21;141
2020-04-20;"Trenčiansky kraj";15;0;0;0;NA;148091;15;2020-04-20;130
2020-04-19;"Trenčiansky kraj";2;0;0;0;NA;148091;2;2020-04-19;115
2020-04-18;"Trenčiansky kraj";3;0;0;0;NA;148091;3;2020-04-18;113
2020-04-17;"Trenčiansky kraj";4;0;0;0;NA;148091;4;2020-04-17;110
2020-04-16;"Trenčiansky kraj";10;0;0;0;NA;148091;10;2020-04-16;106
2020-04-15;"Trenčiansky kraj";4;0;0;0;NA;148091;4;2020-04-15;96
2020-04-14;"Trenčiansky kraj";0;0;0;0;NA;148091;0;2020-04-14;92
2020-04-13;"Trenčiansky kraj";1;0;0;0;NA;148091;1;2020-04-13;92
2020-04-12;"Trenčiansky kraj";2;0;0;0;NA;148091;2;2020-04-12;91
2020-04-11;"Trenčiansky kraj";3;0;0;0;NA;148091;3;2020-04-11;89
2020-04-10;"Trenčiansky kraj";0;0;0;0;NA;148091;0;2020-04-10;86
2020-04-09;"Trenčiansky kraj";0;0;0;0;NA;148091;0;2020-04-09;86
2020-04-08;"Trenčiansky kraj";2;0;0;0;NA;148091;2;2020-04-08;86
2020-04-07;"Trenčiansky kraj";18;0;0;0;NA;148091;18;2020-04-07;84
2020-04-06;"Trenčiansky kraj";0;0;0;0;NA;148091;0;2020-04-06;66
2020-04-05;"Trenčiansky kraj";3;0;0;0;NA;148091;3;2020-04-05;66
2020-04-04;"Trenčiansky kraj";5;0;0;0;NA;148091;5;2020-04-04;63
2020-04-03;"Trenčiansky kraj";4;0;0;0;NA;148091;4;2020-04-03;58
2020-04-02;"Trenčiansky kraj";1;0;0;0;NA;148091;1;2020-04-02;54
2020-04-01;"Trenčiansky kraj";3;0;0;0;NA;148091;3;2020-04-01;53
2020-03-31;"Trenčiansky kraj";1;0;0;0;NA;148091;1;2020-03-31;50
2020-03-30;"Trenčiansky kraj";3;0;0;0;NA;148091;3;2020-03-30;49
2020-03-29;"Trenčiansky kraj";6;0;0;0;NA;148091;6;2020-03-29;46
2020-03-28;"Trenčiansky kraj";9;0;0;0;NA;148091;9;2020-03-28;40
2020-03-27;"Trenčiansky kraj";2;0;0;0;NA;148091;2;2020-03-27;31
2020-03-26;"Trenčiansky kraj";6;0;0;0;NA;148091;6;2020-03-26;29
2020-03-25;"Trenčiansky kraj";3;0;0;0;NA;148091;3;2020-03-25;23
2020-03-24;"Trenčiansky kraj";1;0;0;0;NA;148091;1;2020-03-24;20
2020-03-23;"Trenčiansky kraj";0;0;0;0;NA;148091;0;2020-03-23;19
2020-03-22;"Trenčiansky kraj";0;0;0;0;NA;148091;0;2020-03-22;19
2020-03-21;"Trenčiansky kraj";2;0;0;0;NA;148091;2;2020-03-21;19
2020-03-20;"Trenčiansky kraj";2;0;0;0;NA;148091;2;2020-03-20;17
2020-03-19;"Trenčiansky kraj";8;0;0;0;NA;148091;8;2020-03-19;15
2020-03-18;"Trenčiansky kraj";0;0;0;0;NA;148091;0;2020-03-18;7
2020-03-17;"Trenčiansky kraj";0;0;0;0;NA;148091;0;2020-03-17;7
2020-03-16;"Trenčiansky kraj";1;0;0;0;NA;148091;1;2020-03-16;7
2020-03-15;"Trenčiansky kraj";5;0;0;0;NA;148091;5;2020-03-15;6
2020-03-14;"Trenčiansky kraj";0;0;0;0;NA;148091;0;2020-03-14;1
2020-03-13;"Trenčiansky kraj";0;0;0;0;NA;148091;0;2020-03-13;1
2020-03-12;"Trenčiansky kraj";1;0;0;0;NA;148091;1;2020-03-12;1
2020-03-11;"Trenčiansky kraj";0;0;0;0;NA;148091;0;2020-03-11;0
2020-03-09;"Trenčiansky kraj";0;0;0;0;NA;148091;0;2020-03-09;0
2020-03-08;"Trenčiansky kraj";0;0;0;0;NA;148091;0;2020-03-08;0
2020-03-07;"Trenčiansky kraj";0;0;0;0;NA;148091;0;2020-03-07;0
2020-03-06;"Trenčiansky kraj";0;0;0;0;NA;148091;0;2020-03-06;0
2021-12-02;"Trnavský kraj";1809;2;0;2;74157;125006;1809;2021-12-02;125006
2021-12-01;"Trnavský kraj";738;1725;103;1828;NA;125006;841;2021-12-01;123197
2021-11-30;"Trnavský kraj";1166;3872;172;4044;NA;125006;1338;2021-11-30;122356
2021-11-29;"Trnavský kraj";814;5051;271;5322;NA;125006;1085;2021-11-29;121018
2021-11-28;"Trnavský kraj";482;3076;146;3222;NA;125006;628;2021-11-28;119933
2021-11-27;"Trnavský kraj";1186;2240;206;2446;NA;125006;1392;2021-11-27;119305
2021-11-26;"Trnavský kraj";880;2833;195;3028;NA;125006;1075;2021-11-26;117913
2021-11-25;"Trnavský kraj";1002;2628;155;2783;NA;125006;1157;2021-11-25;116838
2021-11-24;"Trnavský kraj";1060;3441;250;3691;NA;125006;1310;2021-11-24;115681
2021-11-23;"Trnavský kraj";1078;3714;273;3987;NA;125006;1351;2021-11-23;114371
2021-11-22;"Trnavský kraj";696;4028;295;4323;NA;125006;991;2021-11-22;113020
2021-11-21;"Trnavský kraj";298;2270;212;2482;NA;125006;510;2021-11-21;112029
2021-11-20;"Trnavský kraj";826;1529;196;1725;NA;125006;1022;2021-11-20;111519
2021-11-19;"Trnavský kraj";901;3363;313;3676;NA;125006;1214;2021-11-19;110497
2021-11-18;"Trnavský kraj";796;2871;240;3111;NA;125006;1036;2021-11-18;109283
2021-11-17;"Trnavský kraj";769;1186;139;1325;NA;125006;908;2021-11-17;108247
2021-11-16;"Trnavský kraj";591;2754;206;2960;NA;125006;797;2021-11-16;107339
2021-11-15;"Trnavský kraj";606;3350;239;3589;NA;125006;845;2021-11-15;106542
2021-11-14;"Trnavský kraj";236;1578;141;1719;NA;125006;377;2021-11-14;105697
2021-11-13;"Trnavský kraj";815;1314;132;1446;NA;125006;947;2021-11-13;105320
2021-11-12;"Trnavský kraj";563;2584;156;2740;NA;125006;719;2021-11-12;104373
2021-11-11;"Trnavský kraj";512;2426;161;2587;NA;125006;673;2021-11-11;103654
2021-11-10;"Trnavský kraj";590;2315;173;2488;NA;125006;763;2021-11-10;102981
2021-11-09;"Trnavský kraj";585;2538;187;2725;NA;125006;772;2021-11-09;102218
2021-11-08;"Trnavský kraj";357;2715;163;2878;NA;125006;520;2021-11-08;101446
2021-11-07;"Trnavský kraj";162;1349;111;1460;NA;125006;273;2021-11-07;100926
2021-11-06;"Trnavský kraj";391;1287;82;1369;NA;125006;473;2021-11-06;100653
2021-11-05;"Trnavský kraj";447;2202;102;2304;NA;125006;549;2021-11-05;100180
2021-11-04;"Trnavský kraj";432;2289;112;2401;NA;125006;544;2021-11-04;99631
2021-11-03;"Trnavský kraj";420;2091;97;2188;NA;125006;517;2021-11-03;99087
2021-11-02;"Trnavský kraj";365;2767;124;2891;NA;125006;489;2021-11-02;98570
2021-11-01;"Trnavský kraj";220;583;27;610;NA;125006;247;2021-11-01;98081
2021-10-31;"Trnavský kraj";61;887;62;949;NA;125006;123;2021-10-31;97834
2021-10-30;"Trnavský kraj";251;1099;50;1149;NA;125006;301;2021-10-30;97711
2021-10-29;"Trnavský kraj";312;2123;53;2176;NA;125006;365;2021-10-29;97410
2021-10-28;"Trnavský kraj";339;2034;65;2099;NA;125006;404;2021-10-28;97045
2021-10-27;"Trnavský kraj";232;1884;58;1942;NA;125006;290;2021-10-27;96641
2021-10-26;"Trnavský kraj";366;1964;54;2018;NA;125006;420;2021-10-26;96351
2021-10-25;"Trnavský kraj";142;2786;72;2858;NA;125006;214;2021-10-25;95931
2021-10-24;"Trnavský kraj";11;990;30;1020;NA;125006;41;2021-10-24;95717
2021-10-23;"Trnavský kraj";228;1126;27;1153;NA;125006;255;2021-10-23;95676
2021-10-22;"Trnavský kraj";204;2249;51;2300;NA;125006;255;2021-10-22;95421
2021-10-21;"Trnavský kraj";188;1671;46;1717;NA;125006;234;2021-10-21;95166
2021-10-20;"Trnavský kraj";212;1634;47;1681;NA;125006;259;2021-10-20;94932
2021-10-19;"Trnavský kraj";240;1848;30;1878;NA;125006;270;2021-10-19;94673
2021-10-18;"Trnavský kraj";95;2316;72;2388;NA;125006;167;2021-10-18;94403
2021-10-17;"Trnavský kraj";5;1218;17;1235;NA;125006;22;2021-10-17;94236
2021-10-16;"Trnavský kraj";129;1233;17;1250;NA;125006;146;2021-10-16;94214
2021-10-15;"Trnavský kraj";122;2121;24;2145;NA;125006;146;2021-10-15;94068
2021-10-14;"Trnavský kraj";131;1663;24;1687;NA;125006;155;2021-10-14;93922
2021-10-13;"Trnavský kraj";128;2072;23;2095;NA;125006;151;2021-10-13;93767
2021-10-12;"Trnavský kraj";189;2788;38;2826;NA;125006;227;2021-10-12;93616
2021-10-11;"Trnavský kraj";115;2621;35;2656;NA;125006;150;2021-10-11;93389
2021-10-10;"Trnavský kraj";2;993;15;1008;NA;125006;17;2021-10-10;93239
2021-10-09;"Trnavský kraj";151;1099;10;1109;NA;125006;161;2021-10-09;93222
2021-10-08;"Trnavský kraj";106;2326;34;2360;NA;125006;140;2021-10-08;93061
2021-10-07;"Trnavský kraj";151;1714;25;1739;NA;125006;176;2021-10-07;92921
2021-10-06;"Trnavský kraj";122;1929;27;1956;NA;125006;149;2021-10-06;92745
2021-10-05;"Trnavský kraj";220;3726;34;3760;NA;125006;254;2021-10-05;92596
2021-10-04;"Trnavský kraj";54;1963;47;2010;NA;125006;101;2021-10-04;92342
2021-10-03;"Trnavský kraj";1;1106;17;1123;NA;125006;18;2021-10-03;92241
2021-10-02;"Trnavský kraj";52;1055;12;1067;NA;125006;64;2021-10-02;92223
2021-10-01;"Trnavský kraj";113;2243;17;2260;NA;125006;130;2021-10-01;92159
2021-09-30;"Trnavský kraj";109;1872;18;1890;NA;125006;127;2021-09-30;92029
2021-09-29;"Trnavský kraj";83;1331;11;1342;NA;125006;94;2021-09-29;91902
2021-09-28;"Trnavský kraj";135;1934;31;1965;NA;125006;166;2021-09-28;91808
2021-09-27;"Trnavský kraj";80;2084;25;2109;NA;125006;105;2021-09-27;91642
2021-09-26;"Trnavský kraj";2;1048;12;1060;NA;125006;14;2021-09-26;91537
2021-09-25;"Trnavský kraj";61;1105;9;1114;NA;125006;70;2021-09-25;91523
2021-09-24;"Trnavský kraj";41;2229;15;2244;NA;125006;56;2021-09-24;91453
2021-09-23;"Trnavský kraj";89;1691;16;1707;NA;125006;105;2021-09-23;91397
2021-09-22;"Trnavský kraj";119;1706;28;1734;NA;125006;147;2021-09-22;91292
2021-09-21;"Trnavský kraj";108;1505;17;1522;NA;125006;125;2021-09-21;91145
2021-09-20;"Trnavský kraj";50;1652;20;1672;NA;125006;70;2021-09-20;91020
2021-09-19;"Trnavský kraj";2;924;8;932;NA;125006;10;2021-09-19;90950
2021-09-18;"Trnavský kraj";100;982;6;988;NA;125006;106;2021-09-18;90940
2021-09-17;"Trnavský kraj";77;1709;20;1729;NA;125006;97;2021-09-17;90834
2021-09-16;"Trnavský kraj";105;1279;32;1311;NA;125006;137;2021-09-16;90737
2021-09-15;"Trnavský kraj";59;841;5;846;NA;125006;64;2021-09-15;90600
2021-09-14;"Trnavský kraj";38;1583;12;1595;NA;125006;50;2021-09-14;90536
2021-09-13;"Trnavský kraj";56;1410;16;1426;NA;125006;72;2021-09-13;90486
2021-09-12;"Trnavský kraj";0;653;1;654;NA;125006;1;2021-09-12;90414
2021-09-11;"Trnavský kraj";37;971;10;981;NA;125006;47;2021-09-11;90413
2021-09-10;"Trnavský kraj";43;1441;9;1450;NA;125006;52;2021-09-10;90366
2021-09-09;"Trnavský kraj";42;954;13;967;NA;125006;55;2021-09-09;90314
2021-09-08;"Trnavský kraj";65;802;15;817;NA;125006;80;2021-09-08;90259
2021-09-07;"Trnavský kraj";29;844;5;849;NA;125006;34;2021-09-07;90179
2021-09-06;"Trnavský kraj";18;1234;14;1248;NA;125006;32;2021-09-06;90145
2021-09-05;"Trnavský kraj";2;580;4;584;NA;125006;6;2021-09-05;90113
2021-09-04;"Trnavský kraj";17;868;6;874;NA;125006;23;2021-09-04;90107
2021-09-03;"Trnavský kraj";14;1060;5;1065;NA;125006;19;2021-09-03;90084
2021-09-02;"Trnavský kraj";30;830;10;840;NA;125006;40;2021-09-02;90065
2021-09-01;"Trnavský kraj";6;409;4;413;NA;125006;10;2021-09-01;90025
2021-08-31;"Trnavský kraj";13;884;3;887;NA;125006;16;2021-08-31;90015
2021-08-30;"Trnavský kraj";7;904;1;905;NA;125006;8;2021-08-30;89999
2021-08-29;"Trnavský kraj";8;427;1;428;NA;125006;9;2021-08-29;89991
2021-08-28;"Trnavský kraj";17;694;2;696;NA;125006;19;2021-08-28;89982
2021-08-27;"Trnavský kraj";1;1186;4;1190;NA;125006;5;2021-08-27;89963
2021-08-26;"Trnavský kraj";8;713;3;716;NA;125006;11;2021-08-26;89958
2021-08-25;"Trnavský kraj";11;683;6;689;NA;125006;17;2021-08-25;89947
2021-08-24;"Trnavský kraj";7;801;1;802;NA;125006;8;2021-08-24;89930
2021-08-23;"Trnavský kraj";4;844;1;845;NA;125006;5;2021-08-23;89922
2021-08-22;"Trnavský kraj";0;474;0;474;NA;125006;0;2021-08-22;89917
2021-08-21;"Trnavský kraj";8;703;0;703;NA;125006;8;2021-08-21;89917
2021-08-20;"Trnavský kraj";4;1095;4;1099;NA;125006;8;2021-08-20;89909
2021-08-19;"Trnavský kraj";10;875;3;878;NA;125006;13;2021-08-19;89901
2021-08-18;"Trnavský kraj";6;789;2;791;NA;125006;8;2021-08-18;89888
2021-08-17;"Trnavský kraj";7;524;4;528;NA;125006;11;2021-08-17;89880
2021-08-16;"Trnavský kraj";9;966;3;969;NA;125006;12;2021-08-16;89869
2021-08-15;"Trnavský kraj";0;556;1;557;NA;125006;1;2021-08-15;89857
2021-08-14;"Trnavský kraj";10;801;3;804;NA;125006;13;2021-08-14;89856
2021-08-13;"Trnavský kraj";5;1077;6;1083;NA;125006;11;2021-08-13;89843
2021-08-12;"Trnavský kraj";3;666;3;669;NA;125006;6;2021-08-12;89832
2021-08-11;"Trnavský kraj";7;576;2;578;NA;125006;9;2021-08-11;89826
2021-08-10;"Trnavský kraj";3;757;3;760;NA;125006;6;2021-08-10;89817
2021-08-09;"Trnavský kraj";12;808;0;808;NA;125006;12;2021-08-09;89811
2021-08-08;"Trnavský kraj";1;545;0;545;NA;125006;1;2021-08-08;89799
2021-08-07;"Trnavský kraj";9;724;0;724;NA;125006;9;2021-08-07;89798
2021-08-06;"Trnavský kraj";3;988;0;988;NA;125006;3;2021-08-06;89789
2021-08-05;"Trnavský kraj";2;662;1;663;NA;125006;3;2021-08-05;89786
2021-08-04;"Trnavský kraj";1;891;1;892;NA;125006;2;2021-08-04;89783
2021-08-03;"Trnavský kraj";13;645;0;645;NA;125006;13;2021-08-03;89781
2021-08-02;"Trnavský kraj";2;725;1;726;NA;125006;3;2021-08-02;89768
2021-08-01;"Trnavský kraj";0;565;2;567;NA;125006;2;2021-08-01;89765
2021-07-31;"Trnavský kraj";3;886;0;886;NA;125006;3;2021-07-31;89763
2021-07-30;"Trnavský kraj";3;1084;3;1087;NA;125006;6;2021-07-30;89760
2021-07-29;"Trnavský kraj";1;775;0;775;NA;125006;1;2021-07-29;89754
2021-07-28;"Trnavský kraj";5;794;1;795;NA;125006;6;2021-07-28;89753
2021-07-27;"Trnavský kraj";7;623;2;625;NA;125006;9;2021-07-27;89747
2021-07-26;"Trnavský kraj";2;857;2;859;NA;125006;4;2021-07-26;89738
2021-07-25;"Trnavský kraj";0;707;0;707;NA;125006;0;2021-07-25;89734
2021-07-24;"Trnavský kraj";4;828;2;830;NA;125006;6;2021-07-24;89734
2021-07-23;"Trnavský kraj";3;1057;0;1057;NA;125006;3;2021-07-23;89728
2021-07-22;"Trnavský kraj";0;671;2;673;NA;125006;2;2021-07-22;89725
2021-07-21;"Trnavský kraj";2;660;2;662;NA;125006;4;2021-07-21;89723
2021-07-20;"Trnavský kraj";2;593;0;593;NA;125006;2;2021-07-20;89719
2021-07-19;"Trnavský kraj";9;886;0;886;NA;125006;9;2021-07-19;89717
2021-07-18;"Trnavský kraj";0;600;2;602;NA;125006;2;2021-07-18;89708
2021-07-17;"Trnavský kraj";8;796;0;796;NA;125006;8;2021-07-17;89706
2021-07-16;"Trnavský kraj";11;963;0;963;NA;125006;11;2021-07-16;89698
2021-07-15;"Trnavský kraj";4;832;1;833;NA;125006;5;2021-07-15;89687
2021-07-14;"Trnavský kraj";1;699;1;700;NA;125006;2;2021-07-14;89682
2021-07-13;"Trnavský kraj";1;693;1;694;NA;125006;2;2021-07-13;89680
2021-07-12;"Trnavský kraj";4;959;0;959;NA;125006;4;2021-07-12;89678
2021-07-11;"Trnavský kraj";0;692;0;692;NA;125006;0;2021-07-11;89674
2021-07-10;"Trnavský kraj";1;803;0;803;NA;125006;1;2021-07-10;89674
2021-07-09;"Trnavský kraj";3;1262;3;1265;NA;125006;6;2021-07-09;89673
2021-07-08;"Trnavský kraj";4;755;0;755;NA;125006;4;2021-07-08;89667
2021-07-07;"Trnavský kraj";9;924;2;926;NA;125006;11;2021-07-07;89663
2021-07-06;"Trnavský kraj";2;1401;1;1402;NA;125006;3;2021-07-06;89652
2021-07-05;"Trnavský kraj";1;503;2;505;NA;125006;3;2021-07-05;89649
2021-07-04;"Trnavský kraj";0;1129;3;1132;NA;125006;3;2021-07-04;89646
2021-07-03;"Trnavský kraj";4;815;0;815;NA;125006;4;2021-07-03;89643
2021-07-02;"Trnavský kraj";2;1137;2;1139;NA;125006;4;2021-07-02;89639
2021-07-01;"Trnavský kraj";4;437;0;437;NA;125006;4;2021-07-01;89635
2021-06-30;"Trnavský kraj";0;5135;1;5136;NA;125006;1;2021-06-30;89631
2021-06-29;"Trnavský kraj";4;2563;1;2564;NA;125006;5;2021-06-29;89630
2021-06-28;"Trnavský kraj";2;2600;1;2601;NA;125006;3;2021-06-28;89625
2021-06-27;"Trnavský kraj";0;3213;0;3213;NA;125006;0;2021-06-27;89622
2021-06-26;"Trnavský kraj";3;3871;1;3872;NA;125006;4;2021-06-26;89622
2021-06-25;"Trnavský kraj";2;4374;3;4377;NA;125006;5;2021-06-25;89618
2021-06-24;"Trnavský kraj";4;2520;3;2523;NA;125006;7;2021-06-24;89613
2021-06-23;"Trnavský kraj";4;2842;2;2844;NA;125006;6;2021-06-23;89606
2021-06-22;"Trnavský kraj";2;2996;1;2997;NA;125006;3;2021-06-22;89600
2021-06-21;"Trnavský kraj";6;3114;5;3119;NA;125006;11;2021-06-21;89597
2021-06-20;"Trnavský kraj";0;3952;1;3953;NA;125006;1;2021-06-20;89586
2021-06-19;"Trnavský kraj";3;4735;2;4737;NA;125006;5;2021-06-19;89585
2021-06-18;"Trnavský kraj";5;6125;4;6129;NA;125006;9;2021-06-18;89580
2021-06-17;"Trnavský kraj";3;3340;0;3340;NA;125006;3;2021-06-17;89571
2021-06-16;"Trnavský kraj";6;2926;3;2929;NA;125006;9;2021-06-16;89568
2021-06-15;"Trnavský kraj";8;3234;3;3237;NA;125006;11;2021-06-15;89559
2021-06-14;"Trnavský kraj";2;3829;1;3830;NA;125006;3;2021-06-14;89548
2021-06-13;"Trnavský kraj";0;5001;8;5009;NA;125006;8;2021-06-13;89545
2021-06-12;"Trnavský kraj";11;5807;2;5809;NA;125006;13;2021-06-12;89537
2021-06-11;"Trnavský kraj";17;5850;4;5854;NA;125006;21;2021-06-11;89524
2021-06-10;"Trnavský kraj";14;3476;1;3477;NA;125006;15;2021-06-10;89503
2021-06-09;"Trnavský kraj";10;3681;1;3682;NA;125006;11;2021-06-09;89488
2021-06-08;"Trnavský kraj";8;3344;4;3348;NA;125006;12;2021-06-08;89477
2021-06-07;"Trnavský kraj";12;4498;8;4506;NA;125006;20;2021-06-07;89465
2021-06-06;"Trnavský kraj";0;5517;2;5519;NA;125006;2;2021-06-06;89445
2021-06-05;"Trnavský kraj";20;6905;8;6913;NA;125006;28;2021-06-05;89443
2021-06-04;"Trnavský kraj";9;6735;10;6745;NA;125006;19;2021-06-04;89415
2021-06-03;"Trnavský kraj";14;4361;11;4372;NA;125006;25;2021-06-03;89396
2021-06-02;"Trnavský kraj";4;4148;11;4159;NA;125006;15;2021-06-02;89371
2021-06-01;"Trnavský kraj";18;3662;5;3667;NA;125006;23;2021-06-01;89356
2021-05-31;"Trnavský kraj";14;5515;16;5531;NA;125006;30;2021-05-31;89333
2021-05-30;"Trnavský kraj";0;6473;7;6480;NA;125006;7;2021-05-30;89303
2021-05-29;"Trnavský kraj";11;8964;4;8968;NA;125006;15;2021-05-29;89296
2021-05-28;"Trnavský kraj";14;7160;11;7171;NA;125006;25;2021-05-28;89281
2021-05-27;"Trnavský kraj";22;4753;8;4761;NA;125006;30;2021-05-27;89256
2021-05-26;"Trnavský kraj";6;4870;8;4878;NA;125006;14;2021-05-26;89226
2021-05-25;"Trnavský kraj";19;5026;27;5053;NA;125006;46;2021-05-25;89212
2021-05-24;"Trnavský kraj";15;6520;22;6542;NA;125006;37;2021-05-24;89166
2021-05-23;"Trnavský kraj";0;7920;8;7928;NA;125006;8;2021-05-23;89129
2021-05-22;"Trnavský kraj";13;13381;21;13402;NA;125006;34;2021-05-22;89121
2021-05-21;"Trnavský kraj";16;8525;19;8544;NA;125006;35;2021-05-21;89087
2021-05-20;"Trnavský kraj";15;5511;11;5522;NA;125006;26;2021-05-20;89052
2021-05-19;"Trnavský kraj";18;5431;13;5444;NA;125006;31;2021-05-19;89026
2021-05-18;"Trnavský kraj";26;5768;15;5783;NA;125006;41;2021-05-18;88995
2021-05-17;"Trnavský kraj";17;6262;24;6286;NA;125006;41;2021-05-17;88954
2021-05-16;"Trnavský kraj";10;9984;8;9992;NA;125006;18;2021-05-16;88913
2021-05-15;"Trnavský kraj";11;18525;14;18539;NA;125006;25;2021-05-15;88895
2021-05-14;"Trnavský kraj";34;10279;21;10300;NA;125006;55;2021-05-14;88870
2021-05-13;"Trnavský kraj";26;6913;12;6925;NA;125006;38;2021-05-13;88815
2021-05-12;"Trnavský kraj";34;6621;26;6647;NA;125006;60;2021-05-12;88777
2021-05-11;"Trnavský kraj";32;6393;13;6406;NA;125006;45;2021-05-11;88717
2021-05-10;"Trnavský kraj";58;9139;24;9163;NA;125006;82;2021-05-10;88672
2021-05-09;"Trnavský kraj";21;12570;12;12582;NA;125006;33;2021-05-09;88590
2021-05-08;"Trnavský kraj";4;23028;22;23050;NA;125006;26;2021-05-08;88557
2021-05-07;"Trnavský kraj";26;15465;30;15495;NA;125006;56;2021-05-07;88531
2021-05-06;"Trnavský kraj";22;8407;22;8429;NA;125006;44;2021-05-06;88475
2021-05-05;"Trnavský kraj";34;6273;22;6295;NA;125006;56;2021-05-05;88431
2021-05-04;"Trnavský kraj";51;8538;17;8555;NA;125006;68;2021-05-04;88375
2021-05-03;"Trnavský kraj";20;8957;22;8979;NA;125006;42;2021-05-03;88307
2021-05-02;"Trnavský kraj";0;25657;29;25686;NA;125006;29;2021-05-02;88265
2021-05-01;"Trnavský kraj";30;81353;64;81417;NA;125006;94;2021-05-01;88236
2021-04-30;"Trnavský kraj";45;26846;35;26881;NA;125006;80;2021-04-30;88142
2021-04-29;"Trnavský kraj";25;20323;28;20351;NA;125006;53;2021-04-29;88062
2021-04-28;"Trnavský kraj";46;8896;28;8924;NA;125006;74;2021-04-28;88009
2021-04-27;"Trnavský kraj";54;8756;37;8793;NA;125006;91;2021-04-27;87935
2021-04-26;"Trnavský kraj";53;16116;42;16158;NA;125006;95;2021-04-26;87844
2021-04-25;"Trnavský kraj";0;30183;24;30207;NA;125006;24;2021-04-25;87749
2021-04-24;"Trnavský kraj";46;126077;84;126161;NA;125006;130;2021-04-24;87725
2021-04-23;"Trnavský kraj";71;25741;53;25794;NA;125006;124;2021-04-23;87595
2021-04-22;"Trnavský kraj";40;10904;25;10929;NA;125006;65;2021-04-22;87471
2021-04-21;"Trnavský kraj";60;10748;45;10793;NA;125006;105;2021-04-21;87406
2021-04-20;"Trnavský kraj";57;13504;28;13532;NA;125006;85;2021-04-20;87301
2021-04-19;"Trnavský kraj";46;14603;18;14621;NA;125006;64;2021-04-19;87216
2021-04-18;"Trnavský kraj";7;40843;43;40886;NA;125006;50;2021-04-18;87152
2021-04-17;"Trnavský kraj";58;118102;89;118191;NA;125006;147;2021-04-17;87102
2021-04-16;"Trnavský kraj";67;25962;48;26010;NA;125006;115;2021-04-16;86955
2021-04-15;"Trnavský kraj";65;11373;36;11409;NA;125006;101;2021-04-15;86840
2021-04-14;"Trnavský kraj";78;18442;53;18495;NA;125006;131;2021-04-14;86739
2021-04-13;"Trnavský kraj";126;9871;44;9915;NA;125006;170;2021-04-13;86608
2021-04-12;"Trnavský kraj";40;15577;40;15617;NA;125006;80;2021-04-12;86438
2021-04-11;"Trnavský kraj";3;44420;44;44464;NA;125006;47;2021-04-11;86358
2021-04-10;"Trnavský kraj";60;123822;107;123929;NA;125006;167;2021-04-10;86311
2021-04-09;"Trnavský kraj";95;26191;34;26225;NA;125006;129;2021-04-09;86144
2021-04-08;"Trnavský kraj";85;10913;54;10967;NA;125006;139;2021-04-08;86015
2021-04-07;"Trnavský kraj";131;15979;81;16060;NA;125006;212;2021-04-07;85876
2021-04-06;"Trnavský kraj";92;20586;90;20676;NA;125006;182;2021-04-06;85664
2021-04-05;"Trnavský kraj";91;7542;17;7559;NA;125006;108;2021-04-05;85482
2021-04-04;"Trnavský kraj";9;28831;49;28880;NA;125006;58;2021-04-04;85374
2021-04-03;"Trnavský kraj";29;144452;186;144638;NA;125006;215;2021-04-03;85316
2021-04-02;"Trnavský kraj";91;17538;33;17571;NA;125006;124;2021-04-02;85101
2021-04-01;"Trnavský kraj";118;22279;71;22350;NA;125006;189;2021-04-01;84977
2021-03-31;"Trnavský kraj";140;15828;82;15910;NA;125006;222;2021-03-31;84788
2021-03-30;"Trnavský kraj";182;10482;79;10561;NA;125006;261;2021-03-30;84566
2021-03-29;"Trnavský kraj";126;19255;122;19377;NA;125006;248;2021-03-29;84305
2021-03-28;"Trnavský kraj";26;50664;134;50798;NA;125006;160;2021-03-28;84057
2021-03-27;"Trnavský kraj";64;130217;246;130463;NA;125006;310;2021-03-27;83897
2021-03-26;"Trnavský kraj";139;30217;130;30347;NA;125006;269;2021-03-26;83587
2021-03-25;"Trnavský kraj";135;14212;80;14292;NA;125006;215;2021-03-25;83318
2021-03-24;"Trnavský kraj";159;10521;89;10610;NA;125006;248;2021-03-24;83103
2021-03-23;"Trnavský kraj";221;12735;104;12839;NA;125006;325;2021-03-23;82855
2021-03-22;"Trnavský kraj";103;17118;110;17228;NA;125006;213;2021-03-22;82530
2021-03-21;"Trnavský kraj";31;49119;150;49269;NA;125006;181;2021-03-21;82317
2021-03-20;"Trnavský kraj";112;136963;317;137280;NA;125006;429;2021-03-20;82136
2021-03-19;"Trnavský kraj";174;29071;137;29208;NA;125006;311;2021-03-19;81707
2021-03-18;"Trnavský kraj";158;12217;136;12353;NA;125006;294;2021-03-18;81396
2021-03-17;"Trnavský kraj";245;10434;103;10537;NA;125006;348;2021-03-17;81102
2021-03-16;"Trnavský kraj";311;12811;135;12946;NA;125006;446;2021-03-16;80754
2021-03-15;"Trnavský kraj";127;18271;146;18417;NA;125006;273;2021-03-15;80308
2021-03-14;"Trnavský kraj";14;47608;164;47772;NA;125006;178;2021-03-14;80035
2021-03-13;"Trnavský kraj";155;139224;409;139633;NA;125006;564;2021-03-13;79857
2021-03-12;"Trnavský kraj";201;28566;181;28747;NA;125006;382;2021-03-12;79293
2021-03-11;"Trnavský kraj";204;13301;140;13441;NA;125006;344;2021-03-11;78911
2021-03-10;"Trnavský kraj";242;10583;135;10718;NA;125006;377;2021-03-10;78567
2021-03-09;"Trnavský kraj";442;12824;155;12979;NA;125006;597;2021-03-09;78190
2021-03-08;"Trnavský kraj";182;21812;166;21978;NA;125006;348;2021-03-08;77593
2021-03-07;"Trnavský kraj";30;45463;227;45690;NA;125006;257;2021-03-07;77245
2021-03-06;"Trnavský kraj";154;135784;531;136315;NA;125006;685;2021-03-06;76988
2021-03-05;"Trnavský kraj";299;27959;239;28198;NA;125006;538;2021-03-05;76303
2021-03-04;"Trnavský kraj";238;14505;176;14681;NA;125006;414;2021-03-04;75765
2021-03-03;"Trnavský kraj";413;11583;246;11829;NA;125006;659;2021-03-03;75351
2021-03-02;"Trnavský kraj";477;12367;191;12558;NA;125006;668;2021-03-02;74692
2021-03-01;"Trnavský kraj";189;18586;234;18820;NA;125006;423;2021-03-01;74024
2021-02-28;"Trnavský kraj";87;47709;321;48030;NA;125006;408;2021-02-28;73601
2021-02-27;"Trnavský kraj";264;140224;800;141024;NA;125006;1064;2021-02-27;73193
2021-02-26;"Trnavský kraj";362;26637;284;26921;NA;125006;646;2021-02-26;72129
2021-02-25;"Trnavský kraj";433;10490;227;10717;NA;125006;660;2021-02-25;71483
2021-02-24;"Trnavský kraj";407;9113;290;9403;NA;125006;697;2021-02-24;70823
2021-02-23;"Trnavský kraj";469;11322;284;11606;NA;125006;753;2021-02-23;70126
2021-02-22;"Trnavský kraj";206;19901;330;20231;NA;125006;536;2021-02-22;69373
2021-02-21;"Trnavský kraj";38;48221;329;48550;NA;125006;367;2021-02-21;68837
2021-02-20;"Trnavský kraj";273;135835;859;136694;NA;125006;1132;2021-02-20;68470
2021-02-19;"Trnavský kraj";335;26382;366;26748;NA;125006;701;2021-02-19;67338
2021-02-18;"Trnavský kraj";344;11264;348;11612;NA;125006;692;2021-02-18;66637
2021-02-17;"Trnavský kraj";431;8783;416;9199;NA;125006;847;2021-02-17;65945
2021-02-16;"Trnavský kraj";426;11236;294;11530;NA;125006;720;2021-02-16;65098
2021-02-15;"Trnavský kraj";146;18276;326;18602;NA;125006;472;2021-02-15;64378
2021-02-14;"Trnavský kraj";51;57642;495;58137;NA;125006;546;2021-02-14;63906
2021-02-13;"Trnavský kraj";218;137051;994;138045;NA;125006;1212;2021-02-13;63360
2021-02-12;"Trnavský kraj";300;24090;352;24442;NA;125006;652;2021-02-12;62148
2021-02-11;"Trnavský kraj";422;9831;349;10180;NA;125006;771;2021-02-11;61496
2021-02-10;"Trnavský kraj";511;9194;342;9536;NA;125006;853;2021-02-10;60725
2021-02-09;"Trnavský kraj";544;12755;369;13124;NA;125006;913;2021-02-09;59872
2021-02-08;"Trnavský kraj";220;33414;497;33911;NA;125006;717;2021-02-08;58959
2021-02-07;"Trnavský kraj";140;69694;628;70322;NA;125006;768;2021-02-07;58242
2021-02-06;"Trnavský kraj";348;112687;1482;114169;NA;125006;1830;2021-02-06;57474
2021-02-05;"Trnavský kraj";377;16063;373;16436;NA;125006;750;2021-02-05;55644
2021-02-04;"Trnavský kraj";456;7317;456;7773;NA;125006;912;2021-02-04;54894
2021-02-03;"Trnavský kraj";472;6583;434;7017;NA;125006;906;2021-02-03;53982
2021-02-02;"Trnavský kraj";446;14243;424;14667;NA;125006;870;2021-02-02;53076
2021-02-01;"Trnavský kraj";198;38882;679;39561;NA;125006;877;2021-02-01;52206
2021-01-31;"Trnavský kraj";19;64707;822;65529;NA;125006;841;2021-01-31;51329
2021-01-30;"Trnavský kraj";323;111483;1288;112771;NA;125006;1611;2021-01-30;50488
2021-01-29;"Trnavský kraj";421;9689;290;9979;NA;125006;711;2021-01-29;48877
2021-01-28;"Trnavský kraj";389;5817;289;6106;NA;125006;678;2021-01-28;48166
2021-01-27;"Trnavský kraj";433;5554;225;5779;NA;125006;658;2021-01-27;47488
2021-01-26;"Trnavský kraj";565;25411;636;26047;NA;125006;1201;2021-01-26;46830
2021-01-25;"Trnavský kraj";210;41805;620;42425;NA;125006;830;2021-01-25;45629
2021-01-24;"Trnavský kraj";91;66399;779;67178;NA;125006;870;2021-01-24;44799
2021-01-23;"Trnavský kraj";372;113375;1319;114694;NA;125006;1691;2021-01-23;43929
2021-01-22;"Trnavský kraj";217;32755;505;33260;NA;125006;722;2021-01-22;42238
2021-01-21;"Trnavský kraj";311;13913;377;14290;NA;125006;688;2021-01-21;41516
2021-01-20;"Trnavský kraj";503;8685;283;8968;NA;125006;786;2021-01-20;40828
2021-01-19;"Trnavský kraj";415;7013;347;7360;NA;125006;762;2021-01-19;40042
2021-01-18;"Trnavský kraj";247;6690;513;7203;NA;125006;760;2021-01-18;39280
2021-01-17;"Trnavský kraj";128;854;215;1069;NA;125006;343;2021-01-17;38520
2021-01-16;"Trnavský kraj";103;898;24;922;NA;125006;127;2021-01-16;38177
2021-01-15;"Trnavský kraj";278;5467;336;5803;NA;125006;614;2021-01-15;38050
2021-01-14;"Trnavský kraj";452;4001;338;4339;NA;125006;790;2021-01-14;37436
2021-01-13;"Trnavský kraj";457;4751;378;5129;NA;125006;835;2021-01-13;36646
2021-01-12;"Trnavský kraj";469;6860;470;7330;NA;125006;939;2021-01-12;35811
2021-01-11;"Trnavský kraj";370;4587;360;4947;NA;125006;730;2021-01-11;34872
2021-01-10;"Trnavský kraj";71;13;0;13;NA;125006;71;2021-01-10;34142
2021-01-09;"Trnavský kraj";417;1775;100;1875;NA;125006;517;2021-01-09;34071
2021-01-08;"Trnavský kraj";381;6016;506;6522;NA;125006;887;2021-01-08;33554
2021-01-07;"Trnavský kraj";501;3545;329;3874;NA;125006;830;2021-01-07;32667
2021-01-06;"Trnavský kraj";179;758;132;890;NA;125006;311;2021-01-06;31837
2021-01-05;"Trnavský kraj";611;5165;561;5726;NA;125006;1172;2021-01-05;31526
2021-01-04;"Trnavský kraj";302;5556;709;6265;NA;125006;1011;2021-01-04;30354
2021-01-03;"Trnavský kraj";60;53;7;60;NA;125006;67;2021-01-03;29343
2021-01-02;"Trnavský kraj";282;417;32;449;NA;125006;314;2021-01-02;29276
2021-01-01;"Trnavský kraj";143;455;76;531;NA;125006;219;2021-01-01;28962
2020-12-31;"Trnavský kraj";498;8325;820;9145;NA;125006;1318;2020-12-31;28743
2020-12-30;"Trnavský kraj";785;5318;612;5930;NA;125006;1397;2020-12-30;27425
2020-12-29;"Trnavský kraj";322;4913;565;5478;NA;125006;887;2020-12-29;26028
2020-12-28;"Trnavský kraj";213;4900;552;5452;NA;125006;765;2020-12-28;25141
2020-12-27;"Trnavský kraj";27;20;4;24;NA;125006;31;2020-12-27;24376
2020-12-26;"Trnavský kraj";148;44;1;45;NA;125006;149;2020-12-26;24345
2020-12-25;"Trnavský kraj";65;49;5;54;NA;125006;70;2020-12-25;24196
2020-12-24;"Trnavský kraj";333;1359;117;1476;NA;125006;450;2020-12-24;24126
2020-12-23;"Trnavský kraj";210;6672;414;7086;NA;125006;624;2020-12-23;23676
2020-12-22;"Trnavský kraj";311;5427;455;5882;NA;125006;766;2020-12-22;23052
2020-12-21;"Trnavský kraj";328;4092;350;4442;NA;125006;678;2020-12-21;22286
2020-12-20;"Trnavský kraj";134;133;12;145;NA;125006;146;2020-12-20;21608
2020-12-19;"Trnavský kraj";201;1407;103;1510;NA;125006;304;2020-12-19;21462
2020-12-18;"Trnavský kraj";341;4432;334;4766;NA;125006;675;2020-12-18;21158
2020-12-17;"Trnavský kraj";375;4880;414;5294;NA;125006;789;2020-12-17;20483
2020-12-16;"Trnavský kraj";312;4945;383;5328;NA;125006;695;2020-12-16;19694
2020-12-15;"Trnavský kraj";492;6240;598;6838;NA;125006;1090;2020-12-15;18999
2020-12-14;"Trnavský kraj";161;3505;292;3797;NA;125006;453;2020-12-14;17909
2020-12-13;"Trnavský kraj";7;7;0;7;NA;125006;7;2020-12-13;17456
2020-12-12;"Trnavský kraj";254;1456;114;1570;NA;125006;368;2020-12-12;17449
2020-12-11;"Trnavský kraj";384;4289;241;4530;NA;125006;625;2020-12-11;17081
2020-12-10;"Trnavský kraj";183;5197;320;5517;NA;125006;503;2020-12-10;16456
2020-12-09;"Trnavský kraj";521;4199;317;4516;NA;125006;838;2020-12-09;15953
2020-12-08;"Trnavský kraj";281;4090;304;4394;NA;125006;585;2020-12-08;15115
2020-12-07;"Trnavský kraj";178;2895;199;3094;NA;125006;377;2020-12-07;14530
2020-12-06;"Trnavský kraj";46;0;0;0;NA;125006;46;2020-12-06;14153
2020-12-05;"Trnavský kraj";129;2218;41;2259;NA;125006;170;2020-12-05;14107
2020-12-04;"Trnavský kraj";242;3948;158;4106;NA;125006;400;2020-12-04;13937
2020-12-03;"Trnavský kraj";248;2770;190;2960;NA;125006;438;2020-12-03;13537
2020-12-02;"Trnavský kraj";284;4516;176;4692;NA;125006;460;2020-12-02;13099
2020-12-01;"Trnavský kraj";253;3190;205;3395;NA;125006;458;2020-12-01;12639
2020-11-30;"Trnavský kraj";200;7360;186;7546;NA;125006;386;2020-11-30;12181
2020-11-29;"Trnavský kraj";17;738;36;774;NA;125006;53;2020-11-29;11795
2020-11-28;"Trnavský kraj";83;1453;77;1530;NA;125006;160;2020-11-28;11742
2020-11-27;"Trnavský kraj";148;1779;85;1864;NA;125006;233;2020-11-27;11582
2020-11-26;"Trnavský kraj";234;1123;68;1191;NA;125006;302;2020-11-26;11349
2020-11-25;"Trnavský kraj";232;1168;74;1242;NA;125006;306;2020-11-25;11047
2020-11-24;"Trnavský kraj";295;1909;96;2005;NA;125006;391;2020-11-24;10741
2020-11-23;"Trnavský kraj";242;7393;129;7522;NA;125006;371;2020-11-23;10350
2020-11-22;"Trnavský kraj";10;82;9;91;NA;125006;19;2020-11-22;9979
2020-11-21;"Trnavský kraj";129;1354;36;1390;NA;125006;165;2020-11-21;9960
2020-11-20;"Trnavský kraj";246;1154;64;1218;NA;125006;310;2020-11-20;9795
2020-11-19;"Trnavský kraj";157;823;64;887;NA;125006;221;2020-11-19;9485
2020-11-18;"Trnavský kraj";235;822;82;904;NA;125006;317;2020-11-18;9264
2020-11-17;"Trnavský kraj";129;705;74;779;NA;125006;203;2020-11-17;8947
2020-11-16;"Trnavský kraj";187;732;32;764;NA;125006;219;2020-11-16;8744
2020-11-15;"Trnavský kraj";23;73;4;77;NA;125006;27;2020-11-15;8525
2020-11-14;"Trnavský kraj";86;397;12;409;NA;125006;98;2020-11-14;8498
2020-11-13;"Trnavský kraj";219;1312;21;1333;NA;125006;240;2020-11-13;8400
2020-11-12;"Trnavský kraj";162;420;18;438;NA;125006;180;2020-11-12;8160
2020-11-11;"Trnavský kraj";257;392;15;407;NA;125006;272;2020-11-11;7980
2020-11-10;"Trnavský kraj";189;889;30;919;NA;125006;219;2020-11-10;7708
2020-11-09;"Trnavský kraj";196;369;23;392;NA;125006;219;2020-11-09;7489
2020-11-08;"Trnavský kraj";55;400;4;404;NA;125006;59;2020-11-08;7270
2020-11-07;"Trnavský kraj";207;6070;74;6144;NA;125006;281;2020-11-07;7211
2020-11-06;"Trnavský kraj";260;1531;19;1550;NA;125006;279;2020-11-06;6930
2020-11-05;"Trnavský kraj";150;220;27;247;NA;125006;177;2020-11-05;6651
2020-11-04;"Trnavský kraj";188;212;10;222;NA;125006;198;2020-11-04;6474
2020-11-03;"Trnavský kraj";317;127;8;135;NA;125006;325;2020-11-03;6276
2020-11-02;"Trnavský kraj";281;1728;31;1759;NA;125006;312;2020-11-02;5951
2020-11-01;"Trnavský kraj";87;494;27;521;NA;125006;114;2020-11-01;5639
2020-10-31;"Trnavský kraj";259;5024;41;5065;NA;125006;300;2020-10-31;5525
2020-10-30;"Trnavský kraj";198;3784;27;3811;NA;125006;225;2020-10-30;5225
2020-10-29;"Trnavský kraj";273;1461;16;1477;NA;125006;289;2020-10-29;5000
2020-10-28;"Trnavský kraj";319;117;16;133;NA;125006;335;2020-10-28;4711
2020-10-27;"Trnavský kraj";199;461;36;497;NA;125006;235;2020-10-27;4376
2020-10-26;"Trnavský kraj";153;29;2;31;NA;125006;155;2020-10-26;4141
2020-10-25;"Trnavský kraj";95;19;1;20;NA;125006;96;2020-10-25;3986
2020-10-24;"Trnavský kraj";158;109;2;111;NA;125006;160;2020-10-24;3890
2020-10-23;"Trnavský kraj";201;89;4;93;NA;125006;205;2020-10-23;3730
2020-10-22;"Trnavský kraj";195;55;2;57;NA;125006;197;2020-10-22;3525
2020-10-21;"Trnavský kraj";134;73;3;76;NA;125006;137;2020-10-21;3328
2020-10-20;"Trnavský kraj";202;82;3;85;NA;125006;205;2020-10-20;3191
2020-10-19;"Trnavský kraj";67;55;0;55;NA;125006;67;2020-10-19;2986
2020-10-18;"Trnavský kraj";84;0;0;0;NA;125006;84;2020-10-18;2919
2020-10-17;"Trnavský kraj";123;0;0;0;NA;125006;123;2020-10-17;2835
2020-10-16;"Trnavský kraj";86;45;2;47;NA;125006;88;2020-10-16;2712
2020-10-15;"Trnavský kraj";155;66;2;68;NA;125006;157;2020-10-15;2624
2020-10-14;"Trnavský kraj";236;468;3;471;NA;125006;239;2020-10-14;2467
2020-10-13;"Trnavský kraj";138;16;2;18;NA;125006;140;2020-10-13;2228
2020-10-12;"Trnavský kraj";33;41;1;42;NA;125006;34;2020-10-12;2088
2020-10-11;"Trnavský kraj";31;0;0;0;NA;125006;31;2020-10-11;2054
2020-10-10;"Trnavský kraj";128;0;0;0;NA;125006;128;2020-10-10;2023
2020-10-09;"Trnavský kraj";156;0;0;0;NA;125006;156;2020-10-09;1895
2020-10-08;"Trnavský kraj";153;0;0;0;NA;125006;153;2020-10-08;1739
2020-10-07;"Trnavský kraj";80;0;0;0;NA;125006;80;2020-10-07;1586
2020-10-06;"Trnavský kraj";112;0;0;0;NA;125006;112;2020-10-06;1506
2020-10-05;"Trnavský kraj";33;0;0;0;NA;125006;33;2020-10-05;1394
2020-10-04;"Trnavský kraj";44;0;0;0;NA;125006;44;2020-10-04;1361
2020-10-03;"Trnavský kraj";60;0;0;0;NA;125006;60;2020-10-03;1317
2020-10-02;"Trnavský kraj";41;0;0;0;NA;125006;41;2020-10-02;1257
2020-10-01;"Trnavský kraj";53;0;0;0;NA;125006;53;2020-10-01;1216
2020-09-30;"Trnavský kraj";91;0;0;0;NA;125006;91;2020-09-30;1163
2020-09-29;"Trnavský kraj";40;0;0;0;NA;125006;40;2020-09-29;1072
2020-09-28;"Trnavský kraj";69;0;0;0;NA;125006;69;2020-09-28;1032
2020-09-27;"Trnavský kraj";30;0;0;0;NA;125006;30;2020-09-27;963
2020-09-26;"Trnavský kraj";46;0;0;0;NA;125006;46;2020-09-26;933
2020-09-25;"Trnavský kraj";32;0;0;0;NA;125006;32;2020-09-25;887
2020-09-24;"Trnavský kraj";42;0;0;0;NA;125006;42;2020-09-24;855
2020-09-23;"Trnavský kraj";43;0;0;0;NA;125006;43;2020-09-23;813
2020-09-22;"Trnavský kraj";55;0;0;0;NA;125006;55;2020-09-22;770
2020-09-21;"Trnavský kraj";41;0;0;0;NA;125006;41;2020-09-21;715
2020-09-20;"Trnavský kraj";17;0;0;0;NA;125006;17;2020-09-20;674
2020-09-19;"Trnavský kraj";4;0;0;0;NA;125006;4;2020-09-19;657
2020-09-18;"Trnavský kraj";33;0;0;0;NA;125006;33;2020-09-18;653
2020-09-17;"Trnavský kraj";42;0;0;0;NA;125006;42;2020-09-17;620
2020-09-16;"Trnavský kraj";49;0;0;0;NA;125006;49;2020-09-16;578
2020-09-15;"Trnavský kraj";5;0;0;0;NA;125006;5;2020-09-15;529
2020-09-14;"Trnavský kraj";26;0;0;0;NA;125006;26;2020-09-14;524
2020-09-13;"Trnavský kraj";9;0;0;0;NA;125006;9;2020-09-13;498
2020-09-12;"Trnavský kraj";12;0;0;0;NA;125006;12;2020-09-12;489
2020-09-11;"Trnavský kraj";16;0;0;0;NA;125006;16;2020-09-11;477
2020-09-10;"Trnavský kraj";32;0;0;0;NA;125006;32;2020-09-10;461
2020-09-09;"Trnavský kraj";14;0;0;0;NA;125006;14;2020-09-09;429
2020-09-08;"Trnavský kraj";11;0;0;0;NA;125006;11;2020-09-08;415
2020-09-07;"Trnavský kraj";7;0;0;0;NA;125006;7;2020-09-07;404
2020-09-06;"Trnavský kraj";5;0;0;0;NA;125006;5;2020-09-06;397
2020-09-05;"Trnavský kraj";7;0;0;0;NA;125006;7;2020-09-05;392
2020-09-04;"Trnavský kraj";16;0;0;0;NA;125006;16;2020-09-04;385
2020-09-03;"Trnavský kraj";8;0;0;0;NA;125006;8;2020-09-03;369
2020-09-02;"Trnavský kraj";7;0;0;0;NA;125006;7;2020-09-02;361
2020-09-01;"Trnavský kraj";1;0;0;0;NA;125006;1;2020-09-01;354
2020-08-31;"Trnavský kraj";6;0;0;0;NA;125006;6;2020-08-31;353
2020-08-30;"Trnavský kraj";1;0;0;0;NA;125006;1;2020-08-30;347
2020-08-29;"Trnavský kraj";3;0;0;0;NA;125006;3;2020-08-29;346
2020-08-28;"Trnavský kraj";14;0;0;0;NA;125006;14;2020-08-28;343
2020-08-27;"Trnavský kraj";6;0;0;0;NA;125006;6;2020-08-27;329
2020-08-26;"Trnavský kraj";4;0;0;0;NA;125006;4;2020-08-26;323
2020-08-25;"Trnavský kraj";7;0;0;0;NA;125006;7;2020-08-25;319
2020-08-24;"Trnavský kraj";1;0;0;0;NA;125006;1;2020-08-24;312
2020-08-23;"Trnavský kraj";6;0;0;0;NA;125006;6;2020-08-23;311
2020-08-22;"Trnavský kraj";3;0;0;0;NA;125006;3;2020-08-22;305
2020-08-21;"Trnavský kraj";4;0;0;0;NA;125006;4;2020-08-21;302
2020-08-20;"Trnavský kraj";23;0;0;0;NA;125006;23;2020-08-20;298
2020-08-19;"Trnavský kraj";13;0;0;0;NA;125006;13;2020-08-19;275
2020-08-18;"Trnavský kraj";20;0;0;0;NA;125006;20;2020-08-18;262
2020-08-17;"Trnavský kraj";3;0;0;0;NA;125006;3;2020-08-17;242
2020-08-16;"Trnavský kraj";0;0;0;0;NA;125006;0;2020-08-16;239
2020-08-15;"Trnavský kraj";7;0;0;0;NA;125006;7;2020-08-15;239
2020-08-14;"Trnavský kraj";6;0;0;0;NA;125006;6;2020-08-14;232
2020-08-13;"Trnavský kraj";10;0;0;0;NA;125006;10;2020-08-13;226
2020-08-12;"Trnavský kraj";2;0;0;0;NA;125006;2;2020-08-12;216
2020-08-11;"Trnavský kraj";30;0;0;0;NA;125006;30;2020-08-11;214
2020-08-10;"Trnavský kraj";0;0;0;0;NA;125006;0;2020-08-10;184
2020-08-09;"Trnavský kraj";0;0;0;0;NA;125006;0;2020-08-09;184
2020-08-08;"Trnavský kraj";13;0;0;0;NA;125006;13;2020-08-08;184
2020-08-07;"Trnavský kraj";4;0;0;0;NA;125006;4;2020-08-07;171
2020-08-06;"Trnavský kraj";4;0;0;0;NA;125006;4;2020-08-06;167
2020-08-05;"Trnavský kraj";0;0;0;0;NA;125006;0;2020-08-05;163
2020-08-04;"Trnavský kraj";1;0;0;0;NA;125006;1;2020-08-04;163
2020-08-03;"Trnavský kraj";2;0;0;0;NA;125006;2;2020-08-03;162
2020-08-02;"Trnavský kraj";1;0;0;0;NA;125006;1;2020-08-02;160
2020-08-01;"Trnavský kraj";0;0;0;0;NA;125006;0;2020-08-01;159
2020-07-31;"Trnavský kraj";7;0;0;0;NA;125006;7;2020-07-31;159
2020-07-30;"Trnavský kraj";6;0;0;0;NA;125006;6;2020-07-30;152
2020-07-29;"Trnavský kraj";0;0;0;0;NA;125006;0;2020-07-29;146
2020-07-28;"Trnavský kraj";1;0;0;0;NA;125006;1;2020-07-28;146
2020-07-27;"Trnavský kraj";2;0;0;0;NA;125006;2;2020-07-27;145
2020-07-26;"Trnavský kraj";0;0;0;0;NA;125006;0;2020-07-26;143
2020-07-25;"Trnavský kraj";0;0;0;0;NA;125006;0;2020-07-25;143
2020-07-24;"Trnavský kraj";1;0;0;0;NA;125006;1;2020-07-24;143
2020-07-23;"Trnavský kraj";2;0;0;0;NA;125006;2;2020-07-23;142
2020-07-22;"Trnavský kraj";1;0;0;0;NA;125006;1;2020-07-22;140
2020-07-21;"Trnavský kraj";2;0;0;0;NA;125006;2;2020-07-21;139
2020-07-20;"Trnavský kraj";0;0;0;0;NA;125006;0;2020-07-20;137
2020-07-19;"Trnavský kraj";0;0;0;0;NA;125006;0;2020-07-19;137
2020-07-18;"Trnavský kraj";0;0;0;0;NA;125006;0;2020-07-18;137
2020-07-17;"Trnavský kraj";0;0;0;0;NA;125006;0;2020-07-17;137
2020-07-16;"Trnavský kraj";0;0;0;0;NA;125006;0;2020-07-16;137
2020-07-15;"Trnavský kraj";1;0;0;0;NA;125006;1;2020-07-15;137
2020-07-14;"Trnavský kraj";0;0;0;0;NA;125006;0;2020-07-14;136
2020-07-13;"Trnavský kraj";0;0;0;0;NA;125006;0;2020-07-13;136
2020-07-12;"Trnavský kraj";0;0;0;0;NA;125006;0;2020-07-12;136
2020-07-11;"Trnavský kraj";0;0;0;0;NA;125006;0;2020-07-11;136
2020-07-10;"Trnavský kraj";0;0;0;0;NA;125006;0;2020-07-10;136
2020-07-09;"Trnavský kraj";0;0;0;0;NA;125006;0;2020-07-09;136
2020-07-08;"Trnavský kraj";3;0;0;0;NA;125006;3;2020-07-08;136
2020-07-07;"Trnavský kraj";4;0;0;0;NA;125006;4;2020-07-07;133
2020-07-06;"Trnavský kraj";0;0;0;0;NA;125006;0;2020-07-06;129
2020-07-05;"Trnavský kraj";0;0;0;0;NA;125006;0;2020-07-05;129
2020-07-04;"Trnavský kraj";0;0;0;0;NA;125006;0;2020-07-04;129
2020-07-03;"Trnavský kraj";0;0;0;0;NA;125006;0;2020-07-03;129
2020-07-02;"Trnavský kraj";3;0;0;0;NA;125006;3;2020-07-02;129
2020-07-01;"Trnavský kraj";0;0;0;0;NA;125006;0;2020-07-01;126
2020-06-30;"Trnavský kraj";0;0;0;0;NA;125006;0;2020-06-30;126
2020-06-29;"Trnavský kraj";0;0;0;0;NA;125006;0;2020-06-29;126
2020-06-28;"Trnavský kraj";0;0;0;0;NA;125006;0;2020-06-28;126
2020-06-27;"Trnavský kraj";0;0;0;0;NA;125006;0;2020-06-27;126
2020-06-26;"Trnavský kraj";0;0;0;0;NA;125006;0;2020-06-26;126
2020-06-25;"Trnavský kraj";0;0;0;0;NA;125006;0;2020-06-25;126
2020-06-24;"Trnavský kraj";0;0;0;0;NA;125006;0;2020-06-24;126
2020-06-23;"Trnavský kraj";0;0;0;0;NA;125006;0;2020-06-23;126
2020-06-22;"Trnavský kraj";0;0;0;0;NA;125006;0;2020-06-22;126
2020-06-21;"Trnavský kraj";0;0;0;0;NA;125006;0;2020-06-21;126
2020-06-20;"Trnavský kraj";0;0;0;0;NA;125006;0;2020-06-20;126
2020-06-19;"Trnavský kraj";0;0;0;0;NA;125006;0;2020-06-19;126
2020-06-18;"Trnavský kraj";2;0;0;0;NA;125006;2;2020-06-18;126
2020-06-17;"Trnavský kraj";0;0;0;0;NA;125006;0;2020-06-17;124
2020-06-16;"Trnavský kraj";0;0;0;0;NA;125006;0;2020-06-16;124
2020-06-14;"Trnavský kraj";0;0;0;0;NA;125006;0;2020-06-14;124
2020-06-13;"Trnavský kraj";0;0;0;0;NA;125006;0;2020-06-13;124
2020-06-12;"Trnavský kraj";0;0;0;0;NA;125006;0;2020-06-12;124
2020-06-11;"Trnavský kraj";0;0;0;0;NA;125006;0;2020-06-11;124
2020-06-10;"Trnavský kraj";0;0;0;0;NA;125006;0;2020-06-10;124
2020-06-09;"Trnavský kraj";0;0;0;0;NA;125006;0;2020-06-09;124
2020-06-08;"Trnavský kraj";0;0;0;0;NA;125006;0;2020-06-08;124
2020-06-07;"Trnavský kraj";0;0;0;0;NA;125006;0;2020-06-07;124
2020-06-05;"Trnavský kraj";0;0;0;0;NA;125006;0;2020-06-05;124
2020-06-03;"Trnavský kraj";0;0;0;0;NA;125006;0;2020-06-03;124
2020-06-02;"Trnavský kraj";0;0;0;0;NA;125006;0;2020-06-02;124
2020-05-31;"Trnavský kraj";0;0;0;0;NA;125006;0;2020-05-31;124
2020-05-29;"Trnavský kraj";0;0;0;0;NA;125006;0;2020-05-29;124
2020-05-27;"Trnavský kraj";0;0;0;0;NA;125006;0;2020-05-27;124
2020-05-26;"Trnavský kraj";0;0;0;0;NA;125006;0;2020-05-26;124
2020-05-25;"Trnavský kraj";1;0;0;0;NA;125006;1;2020-05-25;124
2020-05-24;"Trnavský kraj";0;0;0;0;NA;125006;0;2020-05-24;123
2020-05-23;"Trnavský kraj";2;0;0;0;NA;125006;2;2020-05-23;123
2020-05-22;"Trnavský kraj";0;0;0;0;NA;125006;0;2020-05-22;121
2020-05-21;"Trnavský kraj";0;0;0;0;NA;125006;0;2020-05-21;121
2020-05-20;"Trnavský kraj";2;0;0;0;NA;125006;2;2020-05-20;121
2020-05-19;"Trnavský kraj";0;0;0;0;NA;125006;0;2020-05-19;119
2020-05-17;"Trnavský kraj";0;0;0;0;NA;125006;0;2020-05-17;119
2020-05-16;"Trnavský kraj";0;0;0;0;NA;125006;0;2020-05-16;119
2020-05-15;"Trnavský kraj";1;0;0;0;NA;125006;1;2020-05-15;119
2020-05-14;"Trnavský kraj";0;0;0;0;NA;125006;0;2020-05-14;118
2020-05-13;"Trnavský kraj";0;0;0;0;NA;125006;0;2020-05-13;118
2020-05-12;"Trnavský kraj";0;0;0;0;NA;125006;0;2020-05-12;118
2020-05-11;"Trnavský kraj";2;0;0;0;NA;125006;2;2020-05-11;118
2020-05-09;"Trnavský kraj";0;0;0;0;NA;125006;0;2020-05-09;116
2020-05-07;"Trnavský kraj";0;0;0;0;NA;125006;0;2020-05-07;116
2020-05-06;"Trnavský kraj";0;0;0;0;NA;125006;0;2020-05-06;116
2020-05-05;"Trnavský kraj";0;0;0;0;NA;125006;0;2020-05-05;116
2020-05-04;"Trnavský kraj";0;0;0;0;NA;125006;0;2020-05-04;116
2020-05-03;"Trnavský kraj";0;0;0;0;NA;125006;0;2020-05-03;116
2020-05-02;"Trnavský kraj";0;0;0;0;NA;125006;0;2020-05-02;116
2020-05-01;"Trnavský kraj";0;0;0;0;NA;125006;0;2020-05-01;116
2020-04-30;"Trnavský kraj";0;0;0;0;NA;125006;0;2020-04-30;116
2020-04-29;"Trnavský kraj";0;0;0;0;NA;125006;0;2020-04-29;116
2020-04-28;"Trnavský kraj";1;0;0;0;NA;125006;1;2020-04-28;116
2020-04-27;"Trnavský kraj";0;0;0;0;NA;125006;0;2020-04-27;115
2020-04-26;"Trnavský kraj";0;0;0;0;NA;125006;0;2020-04-26;115
2020-04-25;"Trnavský kraj";2;0;0;0;NA;125006;2;2020-04-25;115
2020-04-24;"Trnavský kraj";4;0;0;0;NA;125006;4;2020-04-24;113
2020-04-23;"Trnavský kraj";5;0;0;0;NA;125006;5;2020-04-23;109
2020-04-22;"Trnavský kraj";10;0;0;0;NA;125006;10;2020-04-22;104
2020-04-21;"Trnavský kraj";5;0;0;0;NA;125006;5;2020-04-21;94
2020-04-20;"Trnavský kraj";0;0;0;0;NA;125006;0;2020-04-20;89
2020-04-19;"Trnavský kraj";1;0;0;0;NA;125006;1;2020-04-19;89
2020-04-18;"Trnavský kraj";4;0;0;0;NA;125006;4;2020-04-18;88
2020-04-17;"Trnavský kraj";7;0;0;0;NA;125006;7;2020-04-17;84
2020-04-16;"Trnavský kraj";5;0;0;0;NA;125006;5;2020-04-16;77
2020-04-15;"Trnavský kraj";5;0;0;0;NA;125006;5;2020-04-15;72
2020-04-14;"Trnavský kraj";1;0;0;0;NA;125006;1;2020-04-14;67
2020-04-13;"Trnavský kraj";0;0;0;0;NA;125006;0;2020-04-13;66
2020-04-12;"Trnavský kraj";0;0;0;0;NA;125006;0;2020-04-12;66
2020-04-11;"Trnavský kraj";0;0;0;0;NA;125006;0;2020-04-11;66
2020-04-10;"Trnavský kraj";2;0;0;0;NA;125006;2;2020-04-10;66
2020-04-09;"Trnavský kraj";3;0;0;0;NA;125006;3;2020-04-09;64
2020-04-08;"Trnavský kraj";4;0;0;0;NA;125006;4;2020-04-08;61
2020-04-07;"Trnavský kraj";6;0;0;0;NA;125006;6;2020-04-07;57
2020-04-06;"Trnavský kraj";6;0;0;0;NA;125006;6;2020-04-06;51
2020-04-05;"Trnavský kraj";1;0;0;0;NA;125006;1;2020-04-05;45
2020-04-04;"Trnavský kraj";1;0;0;0;NA;125006;1;2020-04-04;44
2020-04-03;"Trnavský kraj";3;0;0;0;NA;125006;3;2020-04-03;43
2020-04-02;"Trnavský kraj";4;0;0;0;NA;125006;4;2020-04-02;40
2020-04-01;"Trnavský kraj";0;0;0;0;NA;125006;0;2020-04-01;36
2020-03-31;"Trnavský kraj";3;0;0;0;NA;125006;3;2020-03-31;36
2020-03-30;"Trnavský kraj";4;0;0;0;NA;125006;4;2020-03-30;33
2020-03-29;"Trnavský kraj";1;0;0;0;NA;125006;1;2020-03-29;29
2020-03-28;"Trnavský kraj";3;0;0;0;NA;125006;3;2020-03-28;28
2020-03-27;"Trnavský kraj";5;0;0;0;NA;125006;5;2020-03-27;25
2020-03-26;"Trnavský kraj";5;0;0;0;NA;125006;5;2020-03-26;20
2020-03-25;"Trnavský kraj";1;0;0;0;NA;125006;1;2020-03-25;15
2020-03-24;"Trnavský kraj";0;0;0;0;NA;125006;0;2020-03-24;14
2020-03-23;"Trnavský kraj";2;0;0;0;NA;125006;2;2020-03-23;14
2020-03-22;"Trnavský kraj";1;0;0;0;NA;125006;1;2020-03-22;12
2020-03-21;"Trnavský kraj";5;0;0;0;NA;125006;5;2020-03-21;11
2020-03-20;"Trnavský kraj";0;0;0;0;NA;125006;0;2020-03-20;6
2020-03-19;"Trnavský kraj";0;0;0;0;NA;125006;0;2020-03-19;6
2020-03-18;"Trnavský kraj";0;0;0;0;NA;125006;0;2020-03-18;6
2020-03-17;"Trnavský kraj";3;0;0;0;NA;125006;3;2020-03-17;6
2020-03-16;"Trnavský kraj";1;0;0;0;NA;125006;1;2020-03-16;3
2020-03-15;"Trnavský kraj";0;0;0;0;NA;125006;0;2020-03-15;2
2020-03-14;"Trnavský kraj";0;0;0;0;NA;125006;0;2020-03-14;2
2020-03-13;"Trnavský kraj";1;0;0;0;NA;125006;1;2020-03-13;2
2020-03-12;"Trnavský kraj";1;0;0;0;NA;125006;1;2020-03-12;1
2020-03-11;"Trnavský kraj";0;0;0;0;NA;125006;0;2020-03-11;0
2020-03-09;"Trnavský kraj";0;0;0;0;NA;125006;0;2020-03-09;0
2020-03-08;"Trnavský kraj";0;0;0;0;NA;125006;0;2020-03-08;0
2020-03-07;"Trnavský kraj";0;0;0;0;NA;125006;0;2020-03-07;0
2020-03-06;"Trnavský kraj";0;0;0;0;NA;125006;0;2020-03-06;0
2021-12-02;"Žilinský kraj";1847;117;10;127;107900;172743;1857;2021-12-02;172743
2021-12-01;"Žilinský kraj";1183;3131;137;3268;NA;172743;1320;2021-12-01;170886
2021-11-30;"Žilinský kraj";1575;5326;239;5565;NA;172743;1814;2021-11-30;169566
2021-11-29;"Žilinský kraj";1395;9063;358;9421;NA;172743;1753;2021-11-29;167752
2021-11-28;"Žilinský kraj";625;4581;235;4816;NA;172743;860;2021-11-28;165999
2021-11-27;"Žilinský kraj";909;2557;192;2749;NA;172743;1101;2021-11-27;165139
2021-11-26;"Žilinský kraj";1195;6580;342;6922;NA;172743;1537;2021-11-26;164038
2021-11-25;"Žilinský kraj";1281;4599;327;4926;NA;172743;1608;2021-11-25;162501
2021-11-24;"Žilinský kraj";1792;4659;324;4983;NA;172743;2116;2021-11-24;160893
2021-11-23;"Žilinský kraj";1630;4654;353;5007;NA;172743;1983;2021-11-23;158777
2021-11-22;"Žilinský kraj";1126;6696;451;7147;NA;172743;1577;2021-11-22;156794
2021-11-21;"Žilinský kraj";443;2865;260;3125;NA;172743;703;2021-11-21;155217
2021-11-20;"Žilinský kraj";963;2104;241;2345;NA;172743;1204;2021-11-20;154514
2021-11-19;"Žilinský kraj";1281;4617;434;5051;NA;172743;1715;2021-11-19;153310
2021-11-18;"Žilinský kraj";1220;4432;376;4808;NA;172743;1596;2021-11-18;151595
2021-11-17;"Žilinský kraj";1001;1434;149;1583;NA;172743;1150;2021-11-17;149999
2021-11-16;"Žilinský kraj";1197;4058;323;4381;NA;172743;1520;2021-11-16;148849
2021-11-15;"Žilinský kraj";977;5050;476;5526;NA;172743;1453;2021-11-15;147329
2021-11-14;"Žilinský kraj";356;2287;262;2549;NA;172743;618;2021-11-14;145876
2021-11-13;"Žilinský kraj";652;1882;220;2102;NA;172743;872;2021-11-13;145258
2021-11-12;"Žilinský kraj";1027;4291;340;4631;NA;172743;1367;2021-11-12;144386
2021-11-11;"Žilinský kraj";924;4192;272;4464;NA;172743;1196;2021-11-11;143019
2021-11-10;"Žilinský kraj";897;4509;305;4814;NA;172743;1202;2021-11-10;141823
2021-11-09;"Žilinský kraj";1440;4619;256;4875;NA;172743;1696;2021-11-09;140621
2021-11-08;"Žilinský kraj";781;4438;425;4863;NA;172743;1206;2021-11-08;138925
2021-11-07;"Žilinský kraj";304;2130;231;2361;NA;172743;535;2021-11-07;137719
2021-11-06;"Žilinský kraj";741;2150;201;2351;NA;172743;942;2021-11-06;137184
2021-11-05;"Žilinský kraj";1064;4067;235;4302;NA;172743;1299;2021-11-05;136242
2021-11-04;"Žilinský kraj";776;3709;232;3941;NA;172743;1008;2021-11-04;134943
2021-11-03;"Žilinský kraj";1106;5550;338;5888;NA;172743;1444;2021-11-03;133935
2021-11-02;"Žilinský kraj";1136;4451;333;4784;NA;172743;1469;2021-11-02;132491
2021-11-01;"Žilinský kraj";399;1456;137;1593;NA;172743;536;2021-11-01;131022
2021-10-31;"Žilinský kraj";344;1387;145;1532;NA;172743;489;2021-10-31;130486
2021-10-30;"Žilinský kraj";571;1944;161;2105;NA;172743;732;2021-10-30;129997
2021-10-29;"Žilinský kraj";733;3339;194;3533;NA;172743;927;2021-10-29;129265
2021-10-28;"Žilinský kraj";639;4953;247;5200;NA;172743;886;2021-10-28;128338
2021-10-27;"Žilinský kraj";739;3446;173;3619;NA;172743;912;2021-10-27;127452
2021-10-26;"Žilinský kraj";945;4748;216;4964;NA;172743;1161;2021-10-26;126540
2021-10-25;"Žilinský kraj";649;5736;271;6007;NA;172743;920;2021-10-25;125379
2021-10-24;"Žilinský kraj";248;1679;107;1786;NA;172743;355;2021-10-24;124459
2021-10-23;"Žilinský kraj";399;2415;149;2564;NA;172743;548;2021-10-23;124104
2021-10-22;"Žilinský kraj";587;3898;151;4049;NA;172743;738;2021-10-22;123556
2021-10-21;"Žilinský kraj";591;3367;162;3529;NA;172743;753;2021-10-21;122818
2021-10-20;"Žilinský kraj";479;3864;154;4018;NA;172743;633;2021-10-20;122065
2021-10-19;"Žilinský kraj";675;3763;161;3924;NA;172743;836;2021-10-19;121432
2021-10-18;"Žilinský kraj";432;5160;271;5431;NA;172743;703;2021-10-18;120596
2021-10-17;"Žilinský kraj";135;1769;101;1870;NA;172743;236;2021-10-17;119893
2021-10-16;"Žilinský kraj";273;2341;100;2441;NA;172743;373;2021-10-16;119657
2021-10-15;"Žilinský kraj";347;3859;146;4005;NA;172743;493;2021-10-15;119284
2021-10-14;"Žilinský kraj";419;3035;110;3145;NA;172743;529;2021-10-14;118791
2021-10-13;"Žilinský kraj";404;3427;112;3539;NA;172743;516;2021-10-13;118262
2021-10-12;"Žilinský kraj";589;4000;141;4141;NA;172743;730;2021-10-12;117746
2021-10-11;"Žilinský kraj";323;4501;154;4655;NA;172743;477;2021-10-11;117016
2021-10-10;"Žilinský kraj";113;1577;77;1654;NA;172743;190;2021-10-10;116539
2021-10-09;"Žilinský kraj";201;1565;57;1622;NA;172743;258;2021-10-09;116349
2021-10-08;"Žilinský kraj";265;4227;99;4326;NA;172743;364;2021-10-08;116091
2021-10-07;"Žilinský kraj";338;3384;113;3497;NA;172743;451;2021-10-07;115727
2021-10-06;"Žilinský kraj";313;3901;89;3990;NA;172743;402;2021-10-06;115276
2021-10-05;"Žilinský kraj";387;4031;122;4153;NA;172743;509;2021-10-05;114874
2021-10-04;"Žilinský kraj";297;4449;121;4570;NA;172743;418;2021-10-04;114365
2021-10-03;"Žilinský kraj";22;1596;63;1659;NA;172743;85;2021-10-03;113947
2021-10-02;"Žilinský kraj";209;1990;45;2035;NA;172743;254;2021-10-02;113862
2021-10-01;"Žilinský kraj";263;4047;104;4151;NA;172743;367;2021-10-01;113608
2021-09-30;"Žilinský kraj";248;3531;71;3602;NA;172743;319;2021-09-30;113241
2021-09-29;"Žilinský kraj";285;3577;82;3659;NA;172743;367;2021-09-29;112922
2021-09-28;"Žilinský kraj";272;3656;73;3729;NA;172743;345;2021-09-28;112555
2021-09-27;"Žilinský kraj";239;4418;152;4570;NA;172743;391;2021-09-27;112210
2021-09-26;"Žilinský kraj";17;1665;42;1707;NA;172743;59;2021-09-26;111819
2021-09-25;"Žilinský kraj";111;1711;50;1761;NA;172743;161;2021-09-25;111760
2021-09-24;"Žilinský kraj";199;6127;98;6225;NA;172743;297;2021-09-24;111599
2021-09-23;"Žilinský kraj";176;2629;74;2703;NA;172743;250;2021-09-23;111302
2021-09-22;"Žilinský kraj";185;2728;77;2805;NA;172743;262;2021-09-22;111052
2021-09-21;"Žilinský kraj";250;3123;78;3201;NA;172743;328;2021-09-21;110790
2021-09-20;"Žilinský kraj";244;3231;95;3326;NA;172743;339;2021-09-20;110462
2021-09-19;"Žilinský kraj";26;1579;37;1616;NA;172743;63;2021-09-19;110123
2021-09-18;"Žilinský kraj";87;1441;45;1486;NA;172743;132;2021-09-18;110060
2021-09-17;"Žilinský kraj";192;3351;56;3407;NA;172743;248;2021-09-17;109928
2021-09-16;"Žilinský kraj";164;2744;87;2831;NA;172743;251;2021-09-16;109680
2021-09-15;"Žilinský kraj";31;555;11;566;NA;172743;42;2021-09-15;109429
2021-09-14;"Žilinský kraj";155;3681;70;3751;NA;172743;225;2021-09-14;109387
2021-09-13;"Žilinský kraj";81;3231;75;3306;NA;172743;156;2021-09-13;109162
2021-09-12;"Žilinský kraj";9;1138;24;1162;NA;172743;33;2021-09-12;109006
2021-09-11;"Žilinský kraj";47;1322;21;1343;NA;172743;68;2021-09-11;108973
2021-09-10;"Žilinský kraj";66;2439;34;2473;NA;172743;100;2021-09-10;108905
2021-09-09;"Žilinský kraj";56;2352;18;2370;NA;172743;74;2021-09-09;108805
2021-09-08;"Žilinský kraj";68;1560;24;1584;NA;172743;92;2021-09-08;108731
2021-09-07;"Žilinský kraj";72;1806;27;1833;NA;172743;99;2021-09-07;108639
2021-09-06;"Žilinský kraj";31;2381;45;2426;NA;172743;76;2021-09-06;108540
2021-09-05;"Žilinský kraj";11;785;8;793;NA;172743;19;2021-09-05;108464
2021-09-04;"Žilinský kraj";24;1080;5;1085;NA;172743;29;2021-09-04;108445
2021-09-03;"Žilinský kraj";52;2047;28;2075;NA;172743;80;2021-09-03;108416
2021-09-02;"Žilinský kraj";30;1432;22;1454;NA;172743;52;2021-09-02;108336
2021-09-01;"Žilinský kraj";5;461;6;467;NA;172743;11;2021-09-01;108284
2021-08-31;"Žilinský kraj";32;1710;15;1725;NA;172743;47;2021-08-31;108273
2021-08-30;"Žilinský kraj";7;1801;4;1805;NA;172743;11;2021-08-30;108226
2021-08-29;"Žilinský kraj";8;631;5;636;NA;172743;13;2021-08-29;108215
2021-08-28;"Žilinský kraj";2;1005;1;1006;NA;172743;3;2021-08-28;108202
2021-08-27;"Žilinský kraj";13;1765;12;1777;NA;172743;25;2021-08-27;108199
2021-08-26;"Žilinský kraj";17;1636;7;1643;NA;172743;24;2021-08-26;108174
2021-08-25;"Žilinský kraj";9;1203;11;1214;NA;172743;20;2021-08-25;108150
2021-08-24;"Žilinský kraj";6;1395;9;1404;NA;172743;15;2021-08-24;108130
2021-08-23;"Žilinský kraj";11;1877;7;1884;NA;172743;18;2021-08-23;108115
2021-08-22;"Žilinský kraj";2;733;3;736;NA;172743;5;2021-08-22;108097
2021-08-21;"Žilinský kraj";6;1183;2;1185;NA;172743;8;2021-08-21;108092
2021-08-20;"Žilinský kraj";7;2284;5;2289;NA;172743;12;2021-08-20;108084
2021-08-19;"Žilinský kraj";6;1281;3;1284;NA;172743;9;2021-08-19;108072
2021-08-18;"Žilinský kraj";4;1331;7;1338;NA;172743;11;2021-08-18;108063
2021-08-17;"Žilinský kraj";9;1219;3;1222;NA;172743;12;2021-08-17;108052
2021-08-16;"Žilinský kraj";14;1696;5;1701;NA;172743;19;2021-08-16;108040
2021-08-15;"Žilinský kraj";1;880;2;882;NA;172743;3;2021-08-15;108021
2021-08-14;"Žilinský kraj";5;1197;0;1197;NA;172743;5;2021-08-14;108018
2021-08-13;"Žilinský kraj";6;1685;0;1685;NA;172743;6;2021-08-13;108013
2021-08-12;"Žilinský kraj";4;1302;4;1306;NA;172743;8;2021-08-12;108007
2021-08-11;"Žilinský kraj";13;1250;3;1253;NA;172743;16;2021-08-11;107999
2021-08-10;"Žilinský kraj";12;1292;3;1295;NA;172743;15;2021-08-10;107983
2021-08-09;"Žilinský kraj";9;1142;1;1143;NA;172743;10;2021-08-09;107968
2021-08-08;"Žilinský kraj";1;748;5;753;NA;172743;6;2021-08-08;107958
2021-08-07;"Žilinský kraj";7;1192;1;1193;NA;172743;8;2021-08-07;107952
2021-08-06;"Žilinský kraj";1;1347;0;1347;NA;172743;1;2021-08-06;107944
2021-08-05;"Žilinský kraj";7;1148;3;1151;NA;172743;10;2021-08-05;107943
2021-08-04;"Žilinský kraj";12;875;0;875;NA;172743;12;2021-08-04;107933
2021-08-03;"Žilinský kraj";11;918;0;918;NA;172743;11;2021-08-03;107921
2021-08-02;"Žilinský kraj";5;1513;1;1514;NA;172743;6;2021-08-02;107910
2021-08-01;"Žilinský kraj";0;679;2;681;NA;172743;2;2021-08-01;107904
2021-07-31;"Žilinský kraj";4;1114;0;1114;NA;172743;4;2021-07-31;107902
2021-07-30;"Žilinský kraj";3;1671;0;1671;NA;172743;3;2021-07-30;107898
2021-07-29;"Žilinský kraj";1;1299;0;1299;NA;172743;1;2021-07-29;107895
2021-07-28;"Žilinský kraj";4;901;0;901;NA;172743;4;2021-07-28;107894
2021-07-27;"Žilinský kraj";11;1378;0;1378;NA;172743;11;2021-07-27;107890
2021-07-26;"Žilinský kraj";1;1301;1;1302;NA;172743;2;2021-07-26;107879
2021-07-25;"Žilinský kraj";2;828;2;830;NA;172743;4;2021-07-25;107877
2021-07-24;"Žilinský kraj";2;1338;2;1340;NA;172743;4;2021-07-24;107873
2021-07-23;"Žilinský kraj";4;1750;0;1750;NA;172743;4;2021-07-23;107869
2021-07-22;"Žilinský kraj";2;1207;0;1207;NA;172743;2;2021-07-22;107865
2021-07-21;"Žilinský kraj";2;1021;0;1021;NA;172743;2;2021-07-21;107863
2021-07-20;"Žilinský kraj";4;1439;0;1439;NA;172743;4;2021-07-20;107861
2021-07-19;"Žilinský kraj";4;1763;1;1764;NA;172743;5;2021-07-19;107857
2021-07-18;"Žilinský kraj";0;854;1;855;NA;172743;1;2021-07-18;107852
2021-07-17;"Žilinský kraj";0;1350;0;1350;NA;172743;0;2021-07-17;107851
2021-07-16;"Žilinský kraj";2;1767;0;1767;NA;172743;2;2021-07-16;107851
2021-07-15;"Žilinský kraj";2;1577;0;1577;NA;172743;2;2021-07-15;107849
2021-07-14;"Žilinský kraj";5;1042;1;1043;NA;172743;6;2021-07-14;107847
2021-07-13;"Žilinský kraj";3;1709;1;1710;NA;172743;4;2021-07-13;107841
2021-07-12;"Žilinský kraj";3;1325;1;1326;NA;172743;4;2021-07-12;107837
2021-07-11;"Žilinský kraj";2;989;0;989;NA;172743;2;2021-07-11;107833
2021-07-10;"Žilinský kraj";1;1511;4;1515;NA;172743;5;2021-07-10;107831
2021-07-09;"Žilinský kraj";1;2208;1;2209;NA;172743;2;2021-07-09;107826
2021-07-08;"Žilinský kraj";6;1776;3;1779;NA;172743;9;2021-07-08;107824
2021-07-07;"Žilinský kraj";1;1585;3;1588;NA;172743;4;2021-07-07;107815
2021-07-06;"Žilinský kraj";4;1956;0;1956;NA;172743;4;2021-07-06;107811
2021-07-05;"Žilinský kraj";2;921;1;922;NA;172743;3;2021-07-05;107807
2021-07-04;"Žilinský kraj";0;921;0;921;NA;172743;0;2021-07-04;107804
2021-07-03;"Žilinský kraj";1;1607;1;1608;NA;172743;2;2021-07-03;107804
2021-07-02;"Žilinský kraj";0;3428;3;3431;NA;172743;3;2021-07-02;107802
2021-07-01;"Žilinský kraj";1;1118;0;1118;NA;172743;1;2021-07-01;107799
2021-06-30;"Žilinský kraj";1;10464;6;10470;NA;172743;7;2021-06-30;107798
2021-06-29;"Žilinský kraj";10;5946;0;5946;NA;172743;10;2021-06-29;107791
2021-06-28;"Žilinský kraj";4;6245;2;6247;NA;172743;6;2021-06-28;107781
2021-06-27;"Žilinský kraj";3;4702;1;4703;NA;172743;4;2021-06-27;107775
2021-06-26;"Žilinský kraj";4;5919;0;5919;NA;172743;4;2021-06-26;107771
2021-06-25;"Žilinský kraj";8;9756;5;9761;NA;172743;13;2021-06-25;107767
2021-06-24;"Žilinský kraj";6;5657;3;5660;NA;172743;9;2021-06-24;107754
2021-06-23;"Žilinský kraj";7;5955;10;5965;NA;172743;17;2021-06-23;107745
2021-06-22;"Žilinský kraj";6;5214;8;5222;NA;172743;14;2021-06-22;107728
2021-06-21;"Žilinský kraj";6;6287;8;6295;NA;172743;14;2021-06-21;107714
2021-06-20;"Žilinský kraj";1;5531;8;5539;NA;172743;9;2021-06-20;107700
2021-06-19;"Žilinský kraj";9;8353;2;8355;NA;172743;11;2021-06-19;107691
2021-06-18;"Žilinský kraj";11;10624;12;10636;NA;172743;23;2021-06-18;107680
2021-06-17;"Žilinský kraj";10;6092;12;6104;NA;172743;22;2021-06-17;107657
2021-06-16;"Žilinský kraj";17;5786;11;5797;NA;172743;28;2021-06-16;107635
2021-06-15;"Žilinský kraj";13;5996;13;6009;NA;172743;26;2021-06-15;107607
2021-06-14;"Žilinský kraj";10;7596;21;7617;NA;172743;31;2021-06-14;107581
2021-06-13;"Žilinský kraj";2;6682;9;6691;NA;172743;11;2021-06-13;107550
2021-06-12;"Žilinský kraj";9;8634;11;8645;NA;172743;20;2021-06-12;107539
2021-06-11;"Žilinský kraj";11;11566;14;11580;NA;172743;25;2021-06-11;107519
2021-06-10;"Žilinský kraj";14;6788;14;6802;NA;172743;28;2021-06-10;107494
2021-06-09;"Žilinský kraj";23;5925;14;5939;NA;172743;37;2021-06-09;107466
2021-06-08;"Žilinský kraj";18;6615;16;6631;NA;172743;34;2021-06-08;107429
2021-06-07;"Žilinský kraj";25;8534;21;8555;NA;172743;46;2021-06-07;107395
2021-06-06;"Žilinský kraj";10;8056;27;8083;NA;172743;37;2021-06-06;107349
2021-06-05;"Žilinský kraj";8;9175;10;9185;NA;172743;18;2021-06-05;107312
2021-06-04;"Žilinský kraj";19;12260;34;12294;NA;172743;53;2021-06-04;107294
2021-06-03;"Žilinský kraj";12;7033;33;7066;NA;172743;45;2021-06-03;107241
2021-06-02;"Žilinský kraj";17;7090;28;7118;NA;172743;45;2021-06-02;107196
2021-06-01;"Žilinský kraj";38;8285;46;8331;NA;172743;84;2021-06-01;107151
2021-05-31;"Žilinský kraj";31;9616;59;9675;NA;172743;90;2021-05-31;107067
2021-05-30;"Žilinský kraj";21;9025;35;9060;NA;172743;56;2021-05-30;106977
2021-05-29;"Žilinský kraj";13;11195;23;11218;NA;172743;36;2021-05-29;106921
2021-05-28;"Žilinský kraj";28;13277;30;13307;NA;172743;58;2021-05-28;106885
2021-05-27;"Žilinský kraj";17;8267;39;8306;NA;172743;56;2021-05-27;106827
2021-05-26;"Žilinský kraj";20;8329;25;8354;NA;172743;45;2021-05-26;106771
2021-05-25;"Žilinský kraj";21;9624;38;9662;NA;172743;59;2021-05-25;106726
2021-05-24;"Žilinský kraj";36;11487;57;11544;NA;172743;93;2021-05-24;106667
2021-05-23;"Žilinský kraj";4;10923;56;10979;NA;172743;60;2021-05-23;106574
2021-05-22;"Žilinský kraj";21;11893;28;11921;NA;172743;49;2021-05-22;106514
2021-05-21;"Žilinský kraj";28;15654;50;15704;NA;172743;78;2021-05-21;106465
2021-05-20;"Žilinský kraj";30;9616;30;9646;NA;172743;60;2021-05-20;106387
2021-05-19;"Žilinský kraj";46;8693;41;8734;NA;172743;87;2021-05-19;106327
2021-05-18;"Žilinský kraj";52;10609;44;10653;NA;172743;96;2021-05-18;106240
2021-05-17;"Žilinský kraj";51;12676;84;12760;NA;172743;135;2021-05-17;106144
2021-05-16;"Žilinský kraj";13;14114;42;14156;NA;172743;55;2021-05-16;106009
2021-05-15;"Žilinský kraj";30;18404;35;18439;NA;172743;65;2021-05-15;105954
2021-05-14;"Žilinský kraj";34;21205;82;21287;NA;172743;116;2021-05-14;105889
2021-05-13;"Žilinský kraj";64;11865;51;11916;NA;172743;115;2021-05-13;105773
2021-05-12;"Žilinský kraj";57;10337;51;10388;NA;172743;108;2021-05-12;105658
2021-05-11;"Žilinský kraj";70;12174;51;12225;NA;172743;121;2021-05-11;105550
2021-05-10;"Žilinský kraj";69;16182;72;16254;NA;172743;141;2021-05-10;105429
2021-05-09;"Žilinský kraj";58;20385;77;20462;NA;172743;135;2021-05-09;105288
2021-05-08;"Žilinský kraj";0;24133;63;24196;NA;172743;63;2021-05-08;105153
2021-05-07;"Žilinský kraj";65;26522;87;26609;NA;172743;152;2021-05-07;105090
2021-05-06;"Žilinský kraj";67;16605;72;16677;NA;172743;139;2021-05-06;104938
2021-05-05;"Žilinský kraj";71;13096;73;13169;NA;172743;144;2021-05-05;104799
2021-05-04;"Žilinský kraj";81;16749;80;16829;NA;172743;161;2021-05-04;104655
2021-05-03;"Žilinský kraj";97;20391;111;20502;NA;172743;208;2021-05-03;104494
2021-05-02;"Žilinský kraj";8;28886;64;28950;NA;172743;72;2021-05-02;104286
2021-05-01;"Žilinský kraj";65;55053;105;55158;NA;172743;170;2021-05-01;104214
2021-04-30;"Žilinský kraj";84;44000;117;44117;NA;172743;201;2021-04-30;104044
2021-04-29;"Žilinský kraj";77;24566;101;24667;NA;172743;178;2021-04-29;103843
2021-04-28;"Žilinský kraj";76;19214;91;19305;NA;172743;167;2021-04-28;103665
2021-04-27;"Žilinský kraj";97;21805;110;21915;NA;172743;207;2021-04-27;103498
2021-04-26;"Žilinský kraj";114;27412;136;27548;NA;172743;250;2021-04-26;103291
2021-04-25;"Žilinský kraj";38;35750;82;35832;NA;172743;120;2021-04-25;103041
2021-04-24;"Žilinský kraj";93;78854;157;79011;NA;172743;250;2021-04-24;102921
2021-04-23;"Žilinský kraj";144;49440;153;49593;NA;172743;297;2021-04-23;102671
2021-04-22;"Žilinský kraj";110;25224;132;25356;NA;172743;242;2021-04-22;102374
2021-04-21;"Žilinský kraj";118;20616;145;20761;NA;172743;263;2021-04-21;102132
2021-04-20;"Žilinský kraj";128;23873;136;24009;NA;172743;264;2021-04-20;101869
2021-04-19;"Žilinský kraj";164;32773;210;32983;NA;172743;374;2021-04-19;101605
2021-04-18;"Žilinský kraj";18;36767;91;36858;NA;172743;109;2021-04-18;101231
2021-04-17;"Žilinský kraj";108;89377;156;89533;NA;172743;264;2021-04-17;101122
2021-04-16;"Žilinský kraj";185;47847;208;48055;NA;172743;393;2021-04-16;100858
2021-04-15;"Žilinský kraj";108;24830;130;24960;NA;172743;238;2021-04-15;100465
2021-04-14;"Žilinský kraj";135;23145;145;23290;NA;172743;280;2021-04-14;100227
2021-04-13;"Žilinský kraj";171;25050;135;25185;NA;172743;306;2021-04-13;99947
2021-04-12;"Žilinský kraj";266;30794;189;30983;NA;172743;455;2021-04-12;99641
2021-04-11;"Žilinský kraj";19;37126;107;37233;NA;172743;126;2021-04-11;99186
2021-04-10;"Žilinský kraj";111;86284;237;86521;NA;172743;348;2021-04-10;99060
2021-04-09;"Žilinský kraj";195;41973;206;42179;NA;172743;401;2021-04-09;98712
2021-04-08;"Žilinský kraj";179;24404;141;24545;NA;172743;320;2021-04-08;98311
2021-04-07;"Žilinský kraj";309;28651;174;28825;NA;172743;483;2021-04-07;97991
2021-04-06;"Žilinský kraj";308;40107;301;40408;NA;172743;609;2021-04-06;97508
2021-04-05;"Žilinský kraj";17;14747;140;14887;NA;172743;157;2021-04-05;96899
2021-04-04;"Žilinský kraj";17;16284;69;16353;NA;172743;86;2021-04-04;96742
2021-04-03;"Žilinský kraj";180;100699;403;101102;NA;172743;583;2021-04-03;96656
2021-04-02;"Žilinský kraj";73;22411;83;22494;NA;172743;156;2021-04-02;96073
2021-04-01;"Žilinský kraj";334;43264;240;43504;NA;172743;574;2021-04-01;95917
2021-03-31;"Žilinský kraj";170;31635;247;31882;NA;172743;417;2021-03-31;95343
2021-03-30;"Žilinský kraj";406;26323;243;26566;NA;172743;649;2021-03-30;94926
2021-03-29;"Žilinský kraj";297;28029;268;28297;NA;172743;565;2021-03-29;94277
2021-03-28;"Žilinský kraj";21;36206;239;36445;NA;172743;260;2021-03-28;93712
2021-03-27;"Žilinský kraj";151;89107;353;89460;NA;172743;504;2021-03-27;93452
2021-03-26;"Žilinský kraj";312;51757;330;52087;NA;172743;642;2021-03-26;92948
2021-03-25;"Žilinský kraj";281;27619;214;27833;NA;172743;495;2021-03-25;92306
2021-03-24;"Žilinský kraj";280;21268;260;21528;NA;172743;540;2021-03-24;91811
2021-03-23;"Žilinský kraj";418;23193;278;23471;NA;172743;696;2021-03-23;91271
2021-03-22;"Žilinský kraj";293;29289;314;29603;NA;172743;607;2021-03-22;90575
2021-03-21;"Žilinský kraj";32;33705;227;33932;NA;172743;259;2021-03-21;89968
2021-03-20;"Žilinský kraj";165;93015;497;93512;NA;172743;662;2021-03-20;89709
2021-03-19;"Žilinský kraj";357;51988;414;52402;NA;172743;771;2021-03-19;89047
2021-03-18;"Žilinský kraj";329;28459;294;28753;NA;172743;623;2021-03-18;88276
2021-03-17;"Žilinský kraj";395;21919;269;22188;NA;172743;664;2021-03-17;87653
2021-03-16;"Žilinský kraj";514;24341;317;24658;NA;172743;831;2021-03-16;86989
2021-03-15;"Žilinský kraj";341;29613;419;30032;NA;172743;760;2021-03-15;86158
2021-03-14;"Žilinský kraj";87;34121;267;34388;NA;172743;354;2021-03-14;85398
2021-03-13;"Žilinský kraj";113;93386;581;93967;NA;172743;694;2021-03-13;85044
2021-03-12;"Žilinský kraj";520;52329;411;52740;NA;172743;931;2021-03-12;84350
2021-03-11;"Žilinský kraj";399;28189;302;28491;NA;172743;701;2021-03-11;83419
2021-03-10;"Žilinský kraj";368;22414;378;22792;NA;172743;746;2021-03-10;82718
2021-03-09;"Žilinský kraj";537;24857;316;25173;NA;172743;853;2021-03-09;81972
2021-03-08;"Žilinský kraj";387;30873;458;31331;NA;172743;845;2021-03-08;81119
2021-03-07;"Žilinský kraj";48;33469;290;33759;NA;172743;338;2021-03-07;80274
2021-03-06;"Žilinský kraj";173;92410;589;92999;NA;172743;762;2021-03-06;79936
2021-03-05;"Žilinský kraj";369;51987;484;52471;NA;172743;853;2021-03-05;79174
2021-03-04;"Žilinský kraj";467;30037;377;30414;NA;172743;844;2021-03-04;78321
2021-03-03;"Žilinský kraj";448;26261;394;26655;NA;172743;842;2021-03-03;77477
2021-03-02;"Žilinský kraj";551;25913;378;26291;NA;172743;929;2021-03-02;76635
2021-03-01;"Žilinský kraj";375;30498;441;30939;NA;172743;816;2021-03-01;75706
2021-02-28;"Žilinský kraj";61;34802;327;35129;NA;172743;388;2021-02-28;74890
2021-02-27;"Žilinský kraj";159;83781;639;84420;NA;172743;798;2021-02-27;74502
2021-02-26;"Žilinský kraj";459;47500;508;48008;NA;172743;967;2021-02-26;73704
2021-02-25;"Žilinský kraj";347;30879;393;31272;NA;172743;740;2021-02-25;72737
2021-02-24;"Žilinský kraj";339;18760;395;19155;NA;172743;734;2021-02-24;71997
2021-02-23;"Žilinský kraj";437;22172;418;22590;NA;172743;855;2021-02-23;71263
2021-02-22;"Žilinský kraj";345;29270;438;29708;NA;172743;783;2021-02-22;70408
2021-02-21;"Žilinský kraj";36;28686;322;29008;NA;172743;358;2021-02-21;69625
2021-02-20;"Žilinský kraj";152;89944;671;90615;NA;172743;823;2021-02-20;69267
2021-02-19;"Žilinský kraj";337;45541;417;45958;NA;172743;754;2021-02-19;68444
2021-02-18;"Žilinský kraj";263;24662;337;24999;NA;172743;600;2021-02-18;67690
2021-02-17;"Žilinský kraj";269;17932;355;18287;NA;172743;624;2021-02-17;67090
2021-02-16;"Žilinský kraj";321;24298;325;24623;NA;172743;646;2021-02-16;66466
2021-02-15;"Žilinský kraj";230;30420;311;30731;NA;172743;541;2021-02-15;65820
2021-02-14;"Žilinský kraj";30;28574;231;28805;NA;172743;261;2021-02-14;65279
2021-02-13;"Žilinský kraj";91;69638;453;70091;NA;172743;544;2021-02-13;65018
2021-02-12;"Žilinský kraj";242;43338;336;43674;NA;172743;578;2021-02-12;64474
2021-02-11;"Žilinský kraj";228;23521;300;23821;NA;172743;528;2021-02-11;63896
2021-02-10;"Žilinský kraj";259;17894;267;18161;NA;172743;526;2021-02-10;63368
2021-02-09;"Žilinský kraj";377;24784;274;25058;NA;172743;651;2021-02-09;62842
2021-02-08;"Žilinský kraj";160;41375;390;41765;NA;172743;550;2021-02-08;62191
2021-02-07;"Žilinský kraj";24;46446;252;46698;NA;172743;276;2021-02-07;61641
2021-02-06;"Žilinský kraj";71;72880;367;73247;NA;172743;438;2021-02-06;61365
2021-02-05;"Žilinský kraj";248;31869;323;32192;NA;172743;571;2021-02-05;60927
2021-02-04;"Žilinský kraj";238;13240;258;13498;NA;172743;496;2021-02-04;60356
2021-02-03;"Žilinský kraj";194;9186;255;9441;NA;172743;449;2021-02-03;59860
2021-02-02;"Žilinský kraj";216;9280;272;9552;NA;172743;488;2021-02-02;59411
2021-02-01;"Žilinský kraj";220;19690;370;20060;NA;172743;590;2021-02-01;58923
2021-01-31;"Žilinský kraj";11;2652;27;2679;NA;172743;38;2021-01-31;58333
2021-01-30;"Žilinský kraj";85;18447;187;18634;NA;172743;272;2021-01-30;58295
2021-01-29;"Žilinský kraj";209;22891;304;23195;NA;172743;513;2021-01-29;58023
2021-01-28;"Žilinský kraj";240;5533;172;5705;NA;172743;412;2021-01-28;57510
2021-01-27;"Žilinský kraj";256;6725;119;6844;NA;172743;375;2021-01-27;57098
2021-01-26;"Žilinský kraj";245;49781;348;50129;NA;172743;593;2021-01-26;56723
2021-01-25;"Žilinský kraj";159;21245;150;21395;NA;172743;309;2021-01-25;56130
2021-01-24;"Žilinský kraj";22;55835;268;56103;NA;172743;290;2021-01-24;55821
2021-01-23;"Žilinský kraj";91;101730;444;102174;NA;172743;535;2021-01-23;55531
2021-01-22;"Žilinský kraj";163;32160;237;32397;NA;172743;400;2021-01-22;54996
2021-01-21;"Žilinský kraj";116;19828;181;20009;NA;172743;297;2021-01-21;54596
2021-01-20;"Žilinský kraj";236;17126;159;17285;NA;172743;395;2021-01-20;54299
2021-01-19;"Žilinský kraj";245;15730;285;16015;NA;172743;530;2021-01-19;53904
2021-01-18;"Žilinský kraj";236;12685;326;13011;NA;172743;562;2021-01-18;53374
2021-01-17;"Žilinský kraj";95;147;8;155;NA;172743;103;2021-01-17;52812
2021-01-16;"Žilinský kraj";14;516;31;547;NA;172743;45;2021-01-16;52709
2021-01-15;"Žilinský kraj";248;7486;209;7695;NA;172743;457;2021-01-15;52664
2021-01-14;"Žilinský kraj";166;5319;239;5558;NA;172743;405;2021-01-14;52207
2021-01-13;"Žilinský kraj";247;11263;557;11820;NA;172743;804;2021-01-13;51802
2021-01-12;"Žilinský kraj";376;8410;385;8795;NA;172743;761;2021-01-12;50998
2021-01-11;"Žilinský kraj";351;10058;465;10523;NA;172743;816;2021-01-11;50237
2021-01-10;"Žilinský kraj";38;229;6;235;NA;172743;44;2021-01-10;49421
2021-01-09;"Žilinský kraj";192;1282;60;1342;NA;172743;252;2021-01-09;49377
2021-01-08;"Žilinský kraj";413;8721;462;9183;NA;172743;875;2021-01-08;49125
2021-01-07;"Žilinský kraj";438;23407;1872;25279;NA;172743;2310;2021-01-07;48250
2021-01-06;"Žilinský kraj";145;1076;67;1143;NA;172743;212;2021-01-06;45940
2021-01-05;"Žilinský kraj";717;10227;796;11023;NA;172743;1513;2021-01-05;45728
2021-01-04;"Žilinský kraj";479;9313;893;10206;NA;172743;1372;2021-01-04;44215
2021-01-03;"Žilinský kraj";13;1006;107;1113;NA;172743;120;2021-01-03;42843
2021-01-02;"Žilinský kraj";98;789;91;880;NA;172743;189;2021-01-02;42723
2021-01-01;"Žilinský kraj";118;241;13;254;NA;172743;131;2021-01-01;42534
2020-12-31;"Žilinský kraj";395;9626;784;10410;NA;172743;1179;2020-12-31;42403
2020-12-30;"Žilinský kraj";1038;11781;823;12604;NA;172743;1861;2020-12-30;41224
2020-12-29;"Žilinský kraj";256;10159;979;11138;NA;172743;1235;2020-12-29;39363
2020-12-28;"Žilinský kraj";406;10704;976;11680;NA;172743;1382;2020-12-28;38128
2020-12-27;"Žilinský kraj";40;684;94;778;NA;172743;134;2020-12-27;36746
2020-12-26;"Žilinský kraj";135;593;48;641;NA;172743;183;2020-12-26;36612
2020-12-25;"Žilinský kraj";66;83;9;92;NA;172743;75;2020-12-25;36429
2020-12-24;"Žilinský kraj";643;667;55;722;NA;172743;698;2020-12-24;36354
2020-12-23;"Žilinský kraj";228;16229;975;17204;NA;172743;1203;2020-12-23;35656
2020-12-22;"Žilinský kraj";519;13483;988;14471;NA;172743;1507;2020-12-22;34453
2020-12-21;"Žilinský kraj";444;12429;1078;13507;NA;172743;1522;2020-12-21;32946
2020-12-20;"Žilinský kraj";36;598;80;678;NA;172743;116;2020-12-20;31424
2020-12-19;"Žilinský kraj";208;1678;127;1805;NA;172743;335;2020-12-19;31308
2020-12-18;"Žilinský kraj";333;6553;370;6923;NA;172743;703;2020-12-18;30973
2020-12-17;"Žilinský kraj";500;3922;262;4184;NA;172743;762;2020-12-17;30270
2020-12-16;"Žilinský kraj";333;3815;267;4082;NA;172743;600;2020-12-16;29508
2020-12-15;"Žilinský kraj";528;3729;340;4069;NA;172743;868;2020-12-15;28908
2020-12-14;"Žilinský kraj";321;3884;309;4193;NA;172743;630;2020-12-14;28040
2020-12-13;"Žilinský kraj";26;494;66;560;NA;172743;92;2020-12-13;27410
2020-12-12;"Žilinský kraj";95;767;46;813;NA;172743;141;2020-12-12;27318
2020-12-11;"Žilinský kraj";455;3938;227;4165;NA;172743;682;2020-12-11;27177
2020-12-10;"Žilinský kraj";166;9129;838;9967;NA;172743;1004;2020-12-10;26495
2020-12-09;"Žilinský kraj";392;2169;132;2301;NA;172743;524;2020-12-09;25491
2020-12-08;"Žilinský kraj";331;3127;101;3228;NA;172743;432;2020-12-08;24967
2020-12-07;"Žilinský kraj";348;2746;162;2908;NA;172743;510;2020-12-07;24535
2020-12-06;"Žilinský kraj";15;128;6;134;NA;172743;21;2020-12-06;24025
2020-12-05;"Žilinský kraj";98;781;41;822;NA;172743;139;2020-12-05;24004
2020-12-04;"Žilinský kraj";228;3091;107;3198;NA;172743;335;2020-12-04;23865
2020-12-03;"Žilinský kraj";237;1609;115;1724;NA;172743;352;2020-12-03;23530
2020-12-02;"Žilinský kraj";181;1710;94;1804;NA;172743;275;2020-12-02;23178
2020-12-01;"Žilinský kraj";209;6239;284;6523;NA;172743;493;2020-12-01;22903
2020-11-30;"Žilinský kraj";203;5326;305;5631;NA;172743;508;2020-11-30;22410
2020-11-29;"Žilinský kraj";18;81;7;88;NA;172743;25;2020-11-29;21902
2020-11-28;"Žilinský kraj";99;349;15;364;NA;172743;114;2020-11-28;21877
2020-11-27;"Žilinský kraj";218;904;46;950;NA;172743;264;2020-11-27;21763
2020-11-26;"Žilinský kraj";190;1041;54;1095;NA;172743;244;2020-11-26;21499
2020-11-25;"Žilinský kraj";225;1217;49;1266;NA;172743;274;2020-11-25;21255
2020-11-24;"Žilinský kraj";213;2139;67;2206;NA;172743;280;2020-11-24;20981
2020-11-23;"Žilinský kraj";170;759;44;803;NA;172743;214;2020-11-23;20701
2020-11-22;"Žilinský kraj";11;67;2;69;NA;172743;13;2020-11-22;20487
2020-11-21;"Žilinský kraj";61;505;20;525;NA;172743;81;2020-11-21;20474
2020-11-20;"Žilinský kraj";251;1074;45;1119;NA;172743;296;2020-11-20;20393
2020-11-19;"Žilinský kraj";252;752;61;813;NA;172743;313;2020-11-19;20097
2020-11-18;"Žilinský kraj";346;348;15;363;NA;172743;361;2020-11-18;19784
2020-11-17;"Žilinský kraj";123;490;15;505;NA;172743;138;2020-11-17;19423
2020-11-16;"Žilinský kraj";227;247;15;262;NA;172743;242;2020-11-16;19285
2020-11-15;"Žilinský kraj";63;13;0;13;NA;172743;63;2020-11-15;19043
2020-11-14;"Žilinský kraj";189;1038;11;1049;NA;172743;200;2020-11-14;18980
2020-11-13;"Žilinský kraj";181;125;9;134;NA;172743;190;2020-11-13;18780
2020-11-12;"Žilinský kraj";334;79;2;81;NA;172743;336;2020-11-12;18590
2020-11-11;"Žilinský kraj";489;147;10;157;NA;172743;499;2020-11-11;18254
2020-11-10;"Žilinský kraj";374;519;9;528;NA;172743;383;2020-11-10;17755
2020-11-09;"Žilinský kraj";143;2335;30;2365;NA;172743;173;2020-11-09;17372
2020-11-08;"Žilinský kraj";59;2538;37;2575;NA;172743;96;2020-11-08;17199
2020-11-07;"Žilinský kraj";312;8175;88;8263;NA;172743;400;2020-11-07;17103
2020-11-06;"Žilinský kraj";503;4090;38;4128;NA;172743;541;2020-11-06;16703
2020-11-05;"Žilinský kraj";473;64;4;68;NA;172743;477;2020-11-05;16162
2020-11-04;"Žilinský kraj";423;178;10;188;NA;172743;433;2020-11-04;15685
2020-11-03;"Žilinský kraj";688;889;16;905;NA;172743;704;2020-11-03;15252
2020-11-02;"Žilinský kraj";472;1043;39;1082;NA;172743;511;2020-11-02;14548
2020-11-01;"Žilinský kraj";349;5096;130;5226;NA;172743;479;2020-11-01;14037
2020-10-31;"Žilinský kraj";661;7963;203;8166;NA;172743;864;2020-10-31;13558
2020-10-30;"Žilinský kraj";529;2575;61;2636;NA;172743;590;2020-10-30;12694
2020-10-29;"Žilinský kraj";740;503;17;520;NA;172743;757;2020-10-29;12104
2020-10-28;"Žilinský kraj";635;105;11;116;NA;172743;646;2020-10-28;11347
2020-10-27;"Žilinský kraj";355;154;24;178;NA;172743;379;2020-10-27;10701
2020-10-26;"Žilinský kraj";148;117;28;145;NA;172743;176;2020-10-26;10322
2020-10-25;"Žilinský kraj";436;0;0;0;NA;172743;436;2020-10-25;10146
2020-10-24;"Žilinský kraj";803;0;0;0;NA;172743;803;2020-10-24;9710
2020-10-23;"Žilinský kraj";659;102;13;115;NA;172743;672;2020-10-23;8907
2020-10-22;"Žilinský kraj";525;33;3;36;NA;172743;528;2020-10-22;8235
2020-10-21;"Žilinský kraj";478;74;14;88;NA;172743;492;2020-10-21;7707
2020-10-20;"Žilinský kraj";524;127;8;135;NA;172743;532;2020-10-20;7215
2020-10-19;"Žilinský kraj";70;80;12;92;NA;172743;82;2020-10-19;6683
2020-10-18;"Žilinský kraj";159;0;0;0;NA;172743;159;2020-10-18;6601
2020-10-17;"Žilinský kraj";509;0;0;0;NA;172743;509;2020-10-17;6442
2020-10-16;"Žilinský kraj";603;51;9;60;NA;172743;612;2020-10-16;5933
2020-10-15;"Žilinský kraj";679;61;3;64;NA;172743;682;2020-10-15;5321
2020-10-14;"Žilinský kraj";523;269;6;275;NA;172743;529;2020-10-14;4639
2020-10-13;"Žilinský kraj";367;458;40;498;NA;172743;407;2020-10-13;4110
2020-10-12;"Žilinský kraj";62;0;0;0;NA;172743;62;2020-10-12;3703
2020-10-11;"Žilinský kraj";50;0;0;0;NA;172743;50;2020-10-11;3641
2020-10-10;"Žilinský kraj";213;0;0;0;NA;172743;213;2020-10-10;3591
2020-10-09;"Žilinský kraj";543;0;0;0;NA;172743;543;2020-10-09;3378
2020-10-08;"Žilinský kraj";238;0;0;0;NA;172743;238;2020-10-08;2835
2020-10-07;"Žilinský kraj";168;0;0;0;NA;172743;168;2020-10-07;2597
2020-10-06;"Žilinský kraj";233;0;0;0;NA;172743;233;2020-10-06;2429
2020-10-05;"Žilinský kraj";33;0;0;0;NA;172743;33;2020-10-05;2196
2020-10-04;"Žilinský kraj";35;0;0;0;NA;172743;35;2020-10-04;2163
2020-10-03;"Žilinský kraj";155;0;0;0;NA;172743;155;2020-10-03;2128
2020-10-02;"Žilinský kraj";105;0;0;0;NA;172743;105;2020-10-02;1973
2020-10-01;"Žilinský kraj";147;0;0;0;NA;172743;147;2020-10-01;1868
2020-09-30;"Žilinský kraj";163;0;0;0;NA;172743;163;2020-09-30;1721
2020-09-29;"Žilinský kraj";105;0;0;0;NA;172743;105;2020-09-29;1558
2020-09-28;"Žilinský kraj";34;0;0;0;NA;172743;34;2020-09-28;1453
2020-09-27;"Žilinský kraj";108;0;0;0;NA;172743;108;2020-09-27;1419
2020-09-26;"Žilinský kraj";96;0;0;0;NA;172743;96;2020-09-26;1311
2020-09-25;"Žilinský kraj";69;0;0;0;NA;172743;69;2020-09-25;1215
2020-09-24;"Žilinský kraj";100;0;0;0;NA;172743;100;2020-09-24;1146
2020-09-23;"Žilinský kraj";65;0;0;0;NA;172743;65;2020-09-23;1046
2020-09-22;"Žilinský kraj";65;0;0;0;NA;172743;65;2020-09-22;981
2020-09-21;"Žilinský kraj";47;0;0;0;NA;172743;47;2020-09-21;916
2020-09-20;"Žilinský kraj";4;0;0;0;NA;172743;4;2020-09-20;869
2020-09-19;"Žilinský kraj";6;0;0;0;NA;172743;6;2020-09-19;865
2020-09-18;"Žilinský kraj";82;0;0;0;NA;172743;82;2020-09-18;859
2020-09-17;"Žilinský kraj";30;0;0;0;NA;172743;30;2020-09-17;777
2020-09-16;"Žilinský kraj";34;0;0;0;NA;172743;34;2020-09-16;747
2020-09-15;"Žilinský kraj";12;0;0;0;NA;172743;12;2020-09-15;713
2020-09-14;"Žilinský kraj";39;0;0;0;NA;172743;39;2020-09-14;701
2020-09-13;"Žilinský kraj";6;0;0;0;NA;172743;6;2020-09-13;662
2020-09-12;"Žilinský kraj";4;0;0;0;NA;172743;4;2020-09-12;656
2020-09-11;"Žilinský kraj";31;0;0;0;NA;172743;31;2020-09-11;652
2020-09-10;"Žilinský kraj";31;12;0;12;NA;172743;31;2020-09-10;621
2020-09-09;"Žilinský kraj";23;0;0;0;NA;172743;23;2020-09-09;590
2020-09-08;"Žilinský kraj";25;0;0;0;NA;172743;25;2020-09-08;567
2020-09-07;"Žilinský kraj";11;0;0;0;NA;172743;11;2020-09-07;542
2020-09-06;"Žilinský kraj";0;0;0;0;NA;172743;0;2020-09-06;531
2020-09-05;"Žilinský kraj";2;0;0;0;NA;172743;2;2020-09-05;531
2020-09-04;"Žilinský kraj";33;0;0;0;NA;172743;33;2020-09-04;529
2020-09-03;"Žilinský kraj";18;0;0;0;NA;172743;18;2020-09-03;496
2020-09-02;"Žilinský kraj";16;0;0;0;NA;172743;16;2020-09-02;478
2020-09-01;"Žilinský kraj";4;0;0;0;NA;172743;4;2020-09-01;462
2020-08-31;"Žilinský kraj";5;0;0;0;NA;172743;5;2020-08-31;458
2020-08-30;"Žilinský kraj";3;0;0;0;NA;172743;3;2020-08-30;453
2020-08-29;"Žilinský kraj";5;0;0;0;NA;172743;5;2020-08-29;450
2020-08-28;"Žilinský kraj";13;0;0;0;NA;172743;13;2020-08-28;445
2020-08-27;"Žilinský kraj";18;0;0;0;NA;172743;18;2020-08-27;432
2020-08-26;"Žilinský kraj";8;0;0;0;NA;172743;8;2020-08-26;414
2020-08-25;"Žilinský kraj";2;0;0;0;NA;172743;2;2020-08-25;406
2020-08-24;"Žilinský kraj";5;0;0;0;NA;172743;5;2020-08-24;404
2020-08-23;"Žilinský kraj";0;0;0;0;NA;172743;0;2020-08-23;399
2020-08-22;"Žilinský kraj";0;0;0;0;NA;172743;0;2020-08-22;399
2020-08-21;"Žilinský kraj";10;0;0;0;NA;172743;10;2020-08-21;399
2020-08-20;"Žilinský kraj";13;0;0;0;NA;172743;13;2020-08-20;389
2020-08-19;"Žilinský kraj";7;0;0;0;NA;172743;7;2020-08-19;376
2020-08-18;"Žilinský kraj";9;0;0;0;NA;172743;9;2020-08-18;369
2020-08-17;"Žilinský kraj";1;0;0;0;NA;172743;1;2020-08-17;360
2020-08-16;"Žilinský kraj";0;0;0;0;NA;172743;0;2020-08-16;359
2020-08-15;"Žilinský kraj";0;0;0;0;NA;172743;0;2020-08-15;359
2020-08-14;"Žilinský kraj";4;0;0;0;NA;172743;4;2020-08-14;359
2020-08-13;"Žilinský kraj";2;0;0;0;NA;172743;2;2020-08-13;355
2020-08-12;"Žilinský kraj";0;0;0;0;NA;172743;0;2020-08-12;353
2020-08-11;"Žilinský kraj";4;0;0;0;NA;172743;4;2020-08-11;353
2020-08-10;"Žilinský kraj";1;0;0;0;NA;172743;1;2020-08-10;349
2020-08-09;"Žilinský kraj";0;0;0;0;NA;172743;0;2020-08-09;348
2020-08-08;"Žilinský kraj";3;0;0;0;NA;172743;3;2020-08-08;348
2020-08-07;"Žilinský kraj";8;0;0;0;NA;172743;8;2020-08-07;345
2020-08-06;"Žilinský kraj";1;0;0;0;NA;172743;1;2020-08-06;337
2020-08-05;"Žilinský kraj";1;0;0;0;NA;172743;1;2020-08-05;336
2020-08-04;"Žilinský kraj";2;0;0;0;NA;172743;2;2020-08-04;335
2020-08-03;"Žilinský kraj";0;0;0;0;NA;172743;0;2020-08-03;333
2020-08-02;"Žilinský kraj";1;0;0;0;NA;172743;1;2020-08-02;333
2020-08-01;"Žilinský kraj";0;0;0;0;NA;172743;0;2020-08-01;332
2020-07-31;"Žilinský kraj";4;0;0;0;NA;172743;4;2020-07-31;332
2020-07-30;"Žilinský kraj";2;0;0;0;NA;172743;2;2020-07-30;328
2020-07-29;"Žilinský kraj";2;0;0;0;NA;172743;2;2020-07-29;326
2020-07-28;"Žilinský kraj";4;0;0;0;NA;172743;4;2020-07-28;324
2020-07-27;"Žilinský kraj";6;0;0;0;NA;172743;6;2020-07-27;320
2020-07-26;"Žilinský kraj";0;0;0;0;NA;172743;0;2020-07-26;314
2020-07-25;"Žilinský kraj";0;0;0;0;NA;172743;0;2020-07-25;314
2020-07-24;"Žilinský kraj";2;0;0;0;NA;172743;2;2020-07-24;314
2020-07-23;"Žilinský kraj";0;0;0;0;NA;172743;0;2020-07-23;312
2020-07-22;"Žilinský kraj";1;0;0;0;NA;172743;1;2020-07-22;312
2020-07-21;"Žilinský kraj";2;0;0;0;NA;172743;2;2020-07-21;311
2020-07-20;"Žilinský kraj";3;0;0;0;NA;172743;3;2020-07-20;309
2020-07-19;"Žilinský kraj";0;0;0;0;NA;172743;0;2020-07-19;306
2020-07-18;"Žilinský kraj";0;0;0;0;NA;172743;0;2020-07-18;306
2020-07-17;"Žilinský kraj";2;0;0;0;NA;172743;2;2020-07-17;306
2020-07-16;"Žilinský kraj";2;0;0;0;NA;172743;2;2020-07-16;304
2020-07-15;"Žilinský kraj";2;0;0;0;NA;172743;2;2020-07-15;302
2020-07-14;"Žilinský kraj";1;0;0;0;NA;172743;1;2020-07-14;300
2020-07-13;"Žilinský kraj";0;0;0;0;NA;172743;0;2020-07-13;299
2020-07-12;"Žilinský kraj";0;0;0;0;NA;172743;0;2020-07-12;299
2020-07-11;"Žilinský kraj";2;0;0;0;NA;172743;2;2020-07-11;299
2020-07-10;"Žilinský kraj";3;0;0;0;NA;172743;3;2020-07-10;297
2020-07-09;"Žilinský kraj";2;0;0;0;NA;172743;2;2020-07-09;294
2020-07-08;"Žilinský kraj";10;0;0;0;NA;172743;10;2020-07-08;292
2020-07-07;"Žilinský kraj";7;0;0;0;NA;172743;7;2020-07-07;282
2020-07-06;"Žilinský kraj";0;0;0;0;NA;172743;0;2020-07-06;275
2020-07-05;"Žilinský kraj";0;0;0;0;NA;172743;0;2020-07-05;275
2020-07-04;"Žilinský kraj";10;0;0;0;NA;172743;10;2020-07-04;275
2020-07-03;"Žilinský kraj";18;0;0;0;NA;172743;18;2020-07-03;265
2020-07-02;"Žilinský kraj";7;0;0;0;NA;172743;7;2020-07-02;247
2020-07-01;"Žilinský kraj";0;0;0;0;NA;172743;0;2020-07-01;240
2020-06-30;"Žilinský kraj";4;0;0;0;NA;172743;4;2020-06-30;240
2020-06-29;"Žilinský kraj";0;0;0;0;NA;172743;0;2020-06-29;236
2020-06-28;"Žilinský kraj";1;0;0;0;NA;172743;1;2020-06-28;236
2020-06-27;"Žilinský kraj";3;0;0;0;NA;172743;3;2020-06-27;235
2020-06-26;"Žilinský kraj";5;0;0;0;NA;172743;5;2020-06-26;232
2020-06-25;"Žilinský kraj";7;0;0;0;NA;172743;7;2020-06-25;227
2020-06-24;"Žilinský kraj";11;0;0;0;NA;172743;11;2020-06-24;220
2020-06-23;"Žilinský kraj";9;0;0;0;NA;172743;9;2020-06-23;209
2020-06-22;"Žilinský kraj";0;0;0;0;NA;172743;0;2020-06-22;200
2020-06-21;"Žilinský kraj";1;0;0;0;NA;172743;1;2020-06-21;200
2020-06-20;"Žilinský kraj";1;0;0;0;NA;172743;1;2020-06-20;199
2020-06-19;"Žilinský kraj";4;0;0;0;NA;172743;4;2020-06-19;198
2020-06-18;"Žilinský kraj";1;0;0;0;NA;172743;1;2020-06-18;194
2020-06-17;"Žilinský kraj";0;0;0;0;NA;172743;0;2020-06-17;193
2020-06-16;"Žilinský kraj";1;0;0;0;NA;172743;1;2020-06-16;193
2020-06-14;"Žilinský kraj";0;0;0;0;NA;172743;0;2020-06-14;192
2020-06-13;"Žilinský kraj";0;0;0;0;NA;172743;0;2020-06-13;192
2020-06-12;"Žilinský kraj";0;0;0;0;NA;172743;0;2020-06-12;192
2020-06-11;"Žilinský kraj";0;0;0;0;NA;172743;0;2020-06-11;192
2020-06-10;"Žilinský kraj";0;0;0;0;NA;172743;0;2020-06-10;192
2020-06-09;"Žilinský kraj";1;0;0;0;NA;172743;1;2020-06-09;192
2020-06-08;"Žilinský kraj";0;0;0;0;NA;172743;0;2020-06-08;191
2020-06-07;"Žilinský kraj";0;0;0;0;NA;172743;0;2020-06-07;191
2020-06-05;"Žilinský kraj";0;0;0;0;NA;172743;0;2020-06-05;191
2020-06-03;"Žilinský kraj";0;0;0;0;NA;172743;0;2020-06-03;191
2020-06-02;"Žilinský kraj";0;0;0;0;NA;172743;0;2020-06-02;191
2020-05-31;"Žilinský kraj";0;0;0;0;NA;172743;0;2020-05-31;191
2020-05-29;"Žilinský kraj";0;0;0;0;NA;172743;0;2020-05-29;191
2020-05-27;"Žilinský kraj";1;0;0;0;NA;172743;1;2020-05-27;191
2020-05-26;"Žilinský kraj";1;0;0;0;NA;172743;1;2020-05-26;190
2020-05-25;"Žilinský kraj";0;0;0;0;NA;172743;0;2020-05-25;189
2020-05-24;"Žilinský kraj";0;0;0;0;NA;172743;0;2020-05-24;189
2020-05-23;"Žilinský kraj";0;0;0;0;NA;172743;0;2020-05-23;189
2020-05-22;"Žilinský kraj";0;0;0;0;NA;172743;0;2020-05-22;189
2020-05-21;"Žilinský kraj";0;0;0;0;NA;172743;0;2020-05-21;189
2020-05-20;"Žilinský kraj";0;0;0;0;NA;172743;0;2020-05-20;189
2020-05-19;"Žilinský kraj";1;0;0;0;NA;172743;1;2020-05-19;189
2020-05-17;"Žilinský kraj";0;0;0;0;NA;172743;0;2020-05-17;188
2020-05-16;"Žilinský kraj";0;0;0;0;NA;172743;0;2020-05-16;188
2020-05-15;"Žilinský kraj";0;0;0;0;NA;172743;0;2020-05-15;188
2020-05-14;"Žilinský kraj";0;0;0;0;NA;172743;0;2020-05-14;188
2020-05-13;"Žilinský kraj";0;0;0;0;NA;172743;0;2020-05-13;188
2020-05-12;"Žilinský kraj";0;0;0;0;NA;172743;0;2020-05-12;188
2020-05-11;"Žilinský kraj";0;0;0;0;NA;172743;0;2020-05-11;188
2020-05-09;"Žilinský kraj";0;0;0;0;NA;172743;0;2020-05-09;188
2020-05-07;"Žilinský kraj";0;0;0;0;NA;172743;0;2020-05-07;188
2020-05-06;"Žilinský kraj";2;0;0;0;NA;172743;2;2020-05-06;188
2020-05-05;"Žilinský kraj";3;0;0;0;NA;172743;3;2020-05-05;186
2020-05-04;"Žilinský kraj";3;0;0;0;NA;172743;3;2020-05-04;183
2020-05-03;"Žilinský kraj";1;0;0;0;NA;172743;1;2020-05-03;180
2020-05-02;"Žilinský kraj";0;0;0;0;NA;172743;0;2020-05-02;179
2020-05-01;"Žilinský kraj";1;0;0;0;NA;172743;1;2020-05-01;179
2020-04-30;"Žilinský kraj";0;0;0;0;NA;172743;0;2020-04-30;178
2020-04-29;"Žilinský kraj";0;0;0;0;NA;172743;0;2020-04-29;178
2020-04-28;"Žilinský kraj";0;0;0;0;NA;172743;0;2020-04-28;178
2020-04-27;"Žilinský kraj";0;0;0;0;NA;172743;0;2020-04-27;178
2020-04-26;"Žilinský kraj";0;0;0;0;NA;172743;0;2020-04-26;178
2020-04-25;"Žilinský kraj";2;0;0;0;NA;172743;2;2020-04-25;178
2020-04-24;"Žilinský kraj";1;0;0;0;NA;172743;1;2020-04-24;176
2020-04-23;"Žilinský kraj";2;0;0;0;NA;172743;2;2020-04-23;175
2020-04-22;"Žilinský kraj";9;0;0;0;NA;172743;9;2020-04-22;173
2020-04-21;"Žilinský kraj";1;0;0;0;NA;172743;1;2020-04-21;164
2020-04-20;"Žilinský kraj";4;0;0;0;NA;172743;4;2020-04-20;163
2020-04-19;"Žilinský kraj";0;0;0;0;NA;172743;0;2020-04-19;159
2020-04-18;"Žilinský kraj";49;0;0;0;NA;172743;49;2020-04-18;159
2020-04-17;"Žilinský kraj";3;0;0;0;NA;172743;3;2020-04-17;110
2020-04-16;"Žilinský kraj";4;0;0;0;NA;172743;4;2020-04-16;107
2020-04-15;"Žilinský kraj";7;0;0;0;NA;172743;7;2020-04-15;103
2020-04-14;"Žilinský kraj";1;0;0;0;NA;172743;1;2020-04-14;96
2020-04-13;"Žilinský kraj";2;0;0;0;NA;172743;2;2020-04-13;95
2020-04-12;"Žilinský kraj";5;0;0;0;NA;172743;5;2020-04-12;93
2020-04-11;"Žilinský kraj";2;0;0;0;NA;172743;2;2020-04-11;88
2020-04-10;"Žilinský kraj";1;0;0;0;NA;172743;1;2020-04-10;86
2020-04-09;"Žilinský kraj";1;0;0;0;NA;172743;1;2020-04-09;85
2020-04-08;"Žilinský kraj";3;0;0;0;NA;172743;3;2020-04-08;84
2020-04-07;"Žilinský kraj";5;0;0;0;NA;172743;5;2020-04-07;81
2020-04-06;"Žilinský kraj";6;0;0;0;NA;172743;6;2020-04-06;76
2020-04-05;"Žilinský kraj";8;0;0;0;NA;172743;8;2020-04-05;70
2020-04-04;"Žilinský kraj";0;0;0;0;NA;172743;0;2020-04-04;62
2020-04-03;"Žilinský kraj";3;0;0;0;NA;172743;3;2020-04-03;62
2020-04-02;"Žilinský kraj";5;0;0;0;NA;172743;5;2020-04-02;59
2020-04-01;"Žilinský kraj";4;0;0;0;NA;172743;4;2020-04-01;54
2020-03-31;"Žilinský kraj";1;0;0;0;NA;172743;1;2020-03-31;50
2020-03-30;"Žilinský kraj";3;0;0;0;NA;172743;3;2020-03-30;49
2020-03-29;"Žilinský kraj";0;0;0;0;NA;172743;0;2020-03-29;46
2020-03-28;"Žilinský kraj";1;0;0;0;NA;172743;1;2020-03-28;46
2020-03-27;"Žilinský kraj";9;0;0;0;NA;172743;9;2020-03-27;45
2020-03-26;"Žilinský kraj";4;0;0;0;NA;172743;4;2020-03-26;36
2020-03-25;"Žilinský kraj";1;0;0;0;NA;172743;1;2020-03-25;32
2020-03-24;"Žilinský kraj";2;0;0;0;NA;172743;2;2020-03-24;31
2020-03-23;"Žilinský kraj";3;0;0;0;NA;172743;3;2020-03-23;29
2020-03-22;"Žilinský kraj";1;0;0;0;NA;172743;1;2020-03-22;26
2020-03-21;"Žilinský kraj";2;0;0;0;NA;172743;2;2020-03-21;25
2020-03-20;"Žilinský kraj";4;0;0;0;NA;172743;4;2020-03-20;23
2020-03-19;"Žilinský kraj";2;0;0;0;NA;172743;2;2020-03-19;19
2020-03-18;"Žilinský kraj";1;0;0;0;NA;172743;1;2020-03-18;17
2020-03-17;"Žilinský kraj";5;0;0;0;NA;172743;5;2020-03-17;16
2020-03-16;"Žilinský kraj";1;0;0;0;NA;172743;1;2020-03-16;11
2020-03-15;"Žilinský kraj";2;0;0;0;NA;172743;2;2020-03-15;10
2020-03-14;"Žilinský kraj";1;0;0;0;NA;172743;1;2020-03-14;8
2020-03-13;"Žilinský kraj";5;0;0;0;NA;172743;5;2020-03-13;7
2020-03-12;"Žilinský kraj";1;0;0;0;NA;172743;1;2020-03-12;2
2020-03-11;"Žilinský kraj";0;0;0;0;NA;172743;0;2020-03-11;1
2020-03-09;"Žilinský kraj";1;0;0;0;NA;172743;1;2020-03-09;1
2020-03-08;"Žilinský kraj";0;0;0;0;NA;172743;0;2020-03-08;0
2020-03-07;"Žilinský kraj";0;0;0;0;NA;172743;0;2020-03-07;0
2020-03-06;"Žilinský kraj";0;0;0;0;NA;172743;0;2020-03-06;0
